abbadísin	a p a t i s I n
affalls	a f a t l s
afferma	a f E r m a
afföll	a f 9 t l_0
afföllin	a f 9 t l I n
afgangateppi	a f k au N k a t_h E h p I
afgreidd	a v k r ei t
afgreiddi	a v k r ei t I
afgreiðslunefnd	a f k r ei D s t l Y n E m t
afgreiðslustelpan	a v k r ei D s t l Y s t E l_0 p a n
afhendingar	a f h E n t i N k a r
afhenta	a f h E n_0 t a
afhentar	a f h E n_0 t a r
afhenti	a f h E n_0 t I
afhöggvinn	a f h 9 k v I n
afklæddist	a v k_h l ai t I s t
aflamarks	a p l a m a r_0 k s
aflamarksbátum	a p l a m a r_0 k s p au t Y m
aflamarkskerfi	a p l a m a r_0 k s c_h E r v I
aflann	a p l a n
aflausn	a v l 9i s t n_0
afleggjaranum	a v l E c a r a n Y m
afleidd	a v l ei t
afleiða	a v l ei D a
afleiðinga	a v l ei D i N k a
afláts	a: v l au t s
aflýsa	a v l i s a
aflýst	a v l i s t
afmælisdegi	a v m ai l I s t ei j I
afmælissöngnum	a v m ai l I s 9i N n Y m
afmörkuð	a v m 9 r_0 k Y D
afraksturinn	a v r a k s t Y r I n
afskekkt	a f s c E x t
afskekkta	a f s c E x t a
afskekktan	a f s c E x t a n
afskiptalaus	a f s c I f t a l 9i s
afskiptasemi	a f s c I f t a s E m I
afskrifa	a f s k r I v a
afskriftareikning	a f s k r I f t a r ei h k n i N k
afskræmt	a f s k r ai m_0 t
afslappaður	a f s t l a h p a D Y r
afslátt	a f s t l au h t
afstöðubreytingu	a f s t 9 D Y p r ei t i N k Y
afstýrt	a f s t i r_0 t
afsögn	a f s 9 k n_0
afsökunarbeiðni	a f s 9 k Y n a r p ei D n I
aftansöngur	a f t a n s 9i N k Y r
aftari	a f t a r I
afturelding	a f t Y r E l t i N k
afturgoldið	a f t Y r k O l t I D
afturkalla	a f t Y r_0 k_h a t l a
afturábak	a f t Y r au p a k
aftöku	a f t_h 9 k Y
afurðatekjum	a: v Y r D a t_h E c Y m
afviknum	a v I h k n Y m
afþakkað	a f T a h k a D
afþreying	a f T r ei j i N k
agalegt	a: G a l E x t
aggagagg	a k a k a k
aginn	ai j I n
akkeri	a h c E r I
akkilesarhæll	a h c I l E s a r_0 h ai t l_0
aknet	a: k n E t
akraness	a: k r a n E s
akrópólis	a: k r ou p_h ou l I s
aksturinn	a k s t Y r I n
akstursklúbbi	a k s t Y r_0 s k_h l u p I
akstursleiðin	a k s t Y r_0 s t l ei D I n
aktygi	a k t_h i j I
aktífir	a x t i v I r
albertsson	a l p E r_0 t s O n
albjart	a l p j a r_0 t
aldinkjötið	a l t i n c_h 9 t I D
aldurstakmarkið	a l t Y r_0 s t_h a k m a r_0 c I D
aldurstengds	a l t Y r_0 s t_h ei N t s
aldurtila	a l t Y r t_h I l a
alfreðs	a l f r E D s
alfreðsdóttir	a l f r E D s t ou h t I r
alfreðsson	a l f r E D s O n
alfreðssonar	a l f r E D s O n a r
alfræðiorðabókin	a l f r ai D I O r D a p ou c I n
alfræðiriti	a l f r ai D I r I t I
algengara	a l c ei N k a r a
algengari	a l c ei N k a r I
algengast	a l c ei N k a s t
algengi	a l c ei J c I
algengum	a l_0 c ei N k Y m
algjörri	a l c 9 r I
alkominn	a l k_h O m I n
alkunna	a l k_h Y n a
alkóa	a l_0 k ou a
allflóknu	a t l f l ou h k n Y
allforhertur	a t l f O r_0 h E r_0 t Y r
allhressilega	a t l_0 r_0 E s I l E G a
allir	a t l I r
alllengi	a t l ei J c I
allmargar	a t l m a r k a r
allmörgum	a t l m 9 r k Y m
allnokkrar	a t l n O h k r a r
allnokkrum	a t l n O h k r Y m
allra	a t l r a
allsber	a l s p E r
allsherjarnefndin	a l s h E r j a r n E m t I n
allsherjarsál	a l s h E r j a r_0 s au l
allsherjartákn	a l s h E r j a r_0 t_h au h k n
allsherjarþinginu	a l s h E r j a r_0 T i J c I n Y
allskonar	a l s k_h O n a r
allskostar	a l s k_h O s t a r
allsráðandi	a l s r au D a n t I
allstaðar	a l s t a D a r
alltaf	a l_0 t a f
alltsvo	a l_0 t s O
alltént	a l_0 t j E n_0 t
almannafæri	a l m a n a f ai r I
almannatenglar	a l m a n a t_h ei N l a r
almannatryggingar	a l m a n a t_h r I c i N k a r
almenningi	a l m E n i J c I
almenninginn	a l m E n i J c I n
almenningsbókasöfn	a l m E n i N s p ou k a s 9 p n_0
almenningssamgangna	a l m E n i N s a m k au N n a
almenningssamgöngur	a l m E n i N s a m k 9i N k Y r
almenningsálitið	a l m E n i N s au l I t I D
almennt	a l m E n_0 t
almennur	a l m E n Y r
alpagreinar	a l_0 p a k r ei n a r
alpaklúbburinn	a l_0 p a k_h l u p Y r I n
alsoddi	a l s O t I
altarissveinn	a l_0 t a r I s v ei t n_0
altekinn	a l t_h E c I n
altsvo	a l_0 t s v O
alvarlega	a l v a r l E G a
alvörugefni	a l v 9 r Y c E p n I
alvörupabba	a l v 9 r Y p_h a p a
alþekkt	a l T E x t
alþingi	a l T i J c I
alþingismanna	a l T i J c I s m a n a
alþjóðabankans	a l T j ou D a p au N_0 k a n s
alþjóðabankinn	a l T j ou D a p au J_0 c I n
alþjóðagjaldeyrissjóðsins	a l T j ou D a c a l t ei r I s j ou D s I n s
alþjóðasamfélagið	a l T j ou D a s a m f j E l ai j I D
alþjóðastofnana	a l T j ou D a s t O p n a n a
alþjóðasveitunum	a l T j ou D a s v ei t O n Y m
alþjóðlegir	a l T j ou D l ei j I r
alþjóðlegra	a l T j ou D l E G r a
alþjóðlegri	a l T j ou D l E G r I
alþýðufylkingarinnar	a l T i D Y f I l_0 c i N k a r I n a r
ameríkaninn	a: m E r i k_h a n I n
amfetamínneytendur	a m f E t a m i n ei t E n t Y r
amma	a m a
amper	a m_0 p E r
andakt	a n t a x t
andartaksstund	a n t a r_0 t_h a k s t Y n t
andartökum	a n t a r t_h 9 k Y m
andavatn	a n t a v a h t n_0
anders	a n t E r_0 s
andesfjöllin	a n t E s f j 9 t l I n
andláti	a n t l au t I
andrúmslofti	a n t r u m s t l O f t I
andrúmsloftið	a n t r u m s t l O f t I D
andskotann	a n t s k O t a n
andskotinn	a n t s k O t I n
andskáldsöguna	a n t s k au l t s 9 G Y n a
andspænis	a n t s p ai n I s
andstyggilega	a n t s t I c I l E G a
andstyggð	a n t s t I G D
andstyggðar	a n t s t I G D a r
andstætt	a n t s t ai h t
andstæða	a n t s t ai D a
andstæðu	a n t s t ai D Y
andsvar	a n t s v a r
andvarpaði	a n t v a r_0 p a D I
andvarpi	a n t v a r_0 p I
angurfull	au N k Y r_0 f Y t l_0
annarlega	a n a r l E G a
annarrar	a n a r a r
annaðhvort	a n a D k_h v O r_0 t
annmörkum	a n m 9 r_0 k Y m
appelsín	a h p E l s i n
appelsínugul	a h p E l s i n Y G Y l
appelsínugulum	a h p E l s i n Y G Y l Y m
appelsínuhúð	a h p E l s i n Y h u D
appelsínur	a h p E l s i n Y r
appelsínusíld	a h p E l s i n Y s i l t
aprílkönnun	a: p_h r i l_0 k_h 9 n Y n
aprílmánuði	a: p_h r i l m au n Y D I
aratungu	a: r a t_h u N k Y
arfi	a r v I
arfleiddi	a r v l ei t I
arfleifð	a r v l ei v D
arftaka	a r f t_h a k a
argentínu	a r c E n t_h i n Y
arkitektarnir	a r_0 c I t_h E x t a r t n I r
arkitektsins	a r_0 c I t_h E x t s I n s
armbandsúr	a r m p a n t s u r
armkútar	a r m_0 k_h u t a r
arnalds	a r t n a l t s
arnarholt	a r t n a r h O l_0 t
arnarsonar	a r t n a r_0 s O n a r
arnartanga	a r t n a r_0 t_h au N k a
arnarvatnsheiðar	a r t n a r v a s h ei D a r
arndal	a r n t a l
arndís	a r n_0 t i s
arnkelsson	a r n_0 c_h E l s O n
artemisar	a r_0 t E m I s a r
arðgreiðslur	a r D k r ei D s t l Y r
asnaeyrunum	a s t n a ei r O n Y m
asnaðist	a s t n a D I s t
atferli	a t f E r t l I
athugasemdir	a: t_h Y G a s E m t I r
athugið	a t_h Yi j I D
athugult	a t_h Y G Y l_0 t
athyglisvert	a t_h I k l I s v E r_0 t
athyglisverð	a t_h I k l I s v E r D
athyglisverða	a t_h I k l I s v E r D a
athyglisverðum	a t_h I k l I s v E r D Y m
athyglisverðustu	a t_h I k l I s v E r D Y s t Y
atkvæða	a t k_h v ai D a
atkvæðagreiðsla	a t k_h v ai D a k r ei D s t l a
atkvæðagreiðslunnar	a t k_h v ai D a k r ei D s t l Y n a r
atkvæðamikill	a t k_h v ai D a m I c I t l
atkvæðanna	a t k_h v ai D a n a
atkvæðisrétt	a t k_h v ai D I s r j E h t
atkvæðum	a t k_h v ai D Y m
atla	a h t l a
atlaga	a: t l a G a
atlantshaf	a h t l a n t s h a v
atlantshafi	a h t l a n t s h a v I
atlasfjalla	a h t l a s f j a t l a
atriðinu	a: t_h r I D I n Y
atviki	a: t v I c I
atvikum	a: t v I k Y m
atvinnuleitandi	a: t v I n Y l ei t a n t I
atvinnuleysi	a: t v I n Y l ei s I
atvinnurekandann	a: t v I n Y r E k a n t a n
atvinnurekendur	a: t v I n Y r E k E n t Y r
atvinnurekstur	a: t v I n Y r E k s t Y r
atvinnutækifæri	a: t v I n Y t_h ai c I f ai r I
atvinnuþátttöku	a: t v I n Y T au h t_h 9 k Y
augabragði	9i: G a p r a G D I
augabrýnnar	9i: G a p r i t n a r
auglýsing	9i G l i s i N k
augnakrókunum	9i k n a k_h r ou k O n Y m
augnatillit	9i k n a t_h I l I t
augnbotna	9i k n p O h t n a
augndeild	9i k n_0 t ei l t
augnsambandi	9i k n_0 s a m p a n t I
augnskugga	9i k n_0 s k Y k a
augnskuggabox	9i k n_0 s k Y k a p O k s
augntóttunum	9i k n t ou h t O n Y m
aukahlutverk	9i: k a l_0 Y t v E r_0 k
aukningin	9i h k n i J c I n
aumingi	9i: m i J c I
aumingja	9i: m i J c a
aumingjann	9i: m i J c a n
aumkunarvert	9i m_0 k Y n a r v E r_0 t
aumkunarverða	9i m_0 k Y n a r v E r D a
austanvert	9i s t a n v E r_0 t
austfirðinga	9i s t f I r D i N k a
austurbæjarskóla	9i s t Y r p ai j a r s k ou l a
austurlanda	9i s t Y r l a n t a
austurlands	9i s t Y r l a n t s
austurríki	9i s t Y r i c I
austurríkismenn	9i s t Y r i c I s m E n
austurríski	9i s t Y r i s c I
austurströnd	9i s t Y r_0 s t r 9 n t
auðkenni	9i D c_h E n I
auðlindagjalds	9i D l I n t a c a l t s
auðlindanefnd	9i D l I n t a n E m t
auðlindanefndar	9i D l I n t a n E m t a r
auðlindanýtingar	9i D l I n t a n i t i N k a r
auðlindarentu	9i D l I n t a r E n_0 t Y
auðmýkingu	9i D m i c i N k Y
auðmýkja	9i D m i c a
auðugra	9i: D Y G r a
auðvaldsins	9i D v a l t s I n s
axarsköft	a k s a r_0 s k 9 f t
axir	a k s I r
aðalbyggingunni	a: D a l p I c i N k Y n I
aðaleinkenni	a: D a l ei J c_h E n I
aðalframkvæmdastjóri	a: D a l f r a m k_h v ai m t a s t j ou r I
aðalfulltrúar	a: D a l f Y l_0 t_h r u a r
aðalfundarstörfum	a: D a l f Y n t a r_0 s t 9 r v Y m
aðalkostur	a: D a l k_h O s t Y r
aðalkvöldfréttatími	a: D a l k_h v 9 l t f r j E h t a t_h i m I
aðallega	a: D a l E G a
aðalnámskránni	a: D a l n au m s k r au n I
aðalpersónan	a: D a l p_h E r_0 s ou n a n
aðalpósthúsinu	a: D a l p_h ou s t_h u s I n Y
aðalsafnaðarfundur	a: D a l s a p n a D a r_0 f Y n t Y r
aðalsafninu	a: D a l s a p n I n Y
aðalsafnsins	a: D a l s a p n_0 s I n s
aðalskipulaginu	a: D a l s c I p Y l ai j I n Y
aðalskipulags	a: D a l s c I p Y l a x s
aðalsteinsdóttir	a: D a l s t ei n s t ou h t I r
aðaltekjulindir	a: D a l t_h E c Y l I n t I r
aðalvandinn	a: D a l v a n t I n
aðalverki	a: D a l v E r_0 c I
aðalverktaka	a: D a l v E r_0 t_h a k a
aðalverktakar	a: D a l v E r_0 t a k a r
aðalverktökum	a: D a l v E r_0 t_h 9 k Y m
aðdragandi	a D t r a G a n t I
aðdáendaklúbbs	a D t au E n t a h k_h l u p s
aðdáunarvert	a D t au Y n a r v E r_0 t
aðflugshallasendum	a D f l Y x s h a t l a s E n t Y m
aðgangsorð	a D k au N s O r D
aðgangur	a D k au N k Y r
aðgengi	a D c ei J c I
aðgengilega	a D c ei J c I l E G a
aðgengilegan	a D c ei J c I l E G a n
aðgengilegasta	a D c ei J c I l E G a s t a
aðgöngumiða	a D k 9i N k Y m I D a
aðhaldssamur	a D h a l t s a m Y r
aðhylltist	a: D h I l_0 t I s t
aðildarlanda	a: D I l t a r l a n t a
aðkasti	a D k_h a s t I
aðkoma	a D k_h O m a
aðkomu	a D k_h O m Y
aðkomumanna	a D k_h O m Y m a n a
aðkomumaður	a: D k_h O m Y m a D Y r
aðrennslisgöng	a D r E n s t l I s k 9i N k
aðstoðarmaðurinn	a D s t O D a r m a D Y r I n
aðstoðaryfirlögregluþjónn	a D s t O D a r I v I r l 9 G r E k l Y T j ou t n_0
aðsóknar	a D s ou h k n a r
aðventukvöld	a D v E n_0 t Y k_h v 9 l t
badda	p a t a
baggalúti	p a k a l u t I
baggalútur	p a k a l u t Y r
bakkaskjóls	p a h k a s c ou l s
bakkelsi	p a h k E l s I
bakkus	p a h k Y s
bakstur	p a k s t Y r
baksvipinn	p a k s v I p I n
bakveröndinni	p a: k v E r 9 n t I n I
bakvið	p a: k v I D
bakþanka	p a k T au N_0 k a
balkanskaga	p a l_0 k a n s k a G a
ballettsins	p a t l E h t s I n s
ballið	p a l I D
bandaríkjadala	p a n t a r i c a t a l a
bandaríkjaforseta	p a n t a r i c a f O r_0 s E t a
bandaríkjaþings	p a n t a r i c a T i N k s
bandarískt	p a n t a r i s t
bandarísku	p a n t a r i s k Y
banginn	p au J c I n
bangsa	p au N s a
bangsanum	p au N s a n Y m
bangsar	p au N s a r
bangsi	p au N s I
bangsinn	p au N s I n
bangsímon	p au N s i m O n
banhungruð	p a: n h u N k r Y D
bank	p au N_0 k
bankakerfinu	p au N_0 k a c_h E r v I n Y
bankakerfið	p au N_0 k a c_h E r v I D
bankalánum	p au N_0 k a l au n Y m
bankamanna	p au N_0 k a m a n a
bankana	p au N_0 k a n a
bankann	p au N_0 k a n
bankanna	p au N_0 k a n a
bankans	p au N_0 k a n s
bankanum	p au N_0 k a n Y m
bankareikning	p au N_0 k a r ei h k n i N k
bankarán	p au N_0 k a r au n
bankaráð	p au N_0 k a r au D
bankastjóra	p au N_0 k a s t j ou r a
bankastræti	p au N_0 k a s t r ai t I
bankaði	p au N_0 k a D I
bankaþjónusta	p au N_0 k a T j ou n Y s t a
bankaþjónustu	p au N_0 k a T j ou n Y s t Y
banki	p au J_0 c I
bankinn	p au J_0 c I n
banks	p au N_0 k s
bardagann	p a r t a G a n
barkakýlið	p a r_0 k a c_h i l I D
barmafullt	p a r m a f Y l_0 t
barnalands	p a r t n a l a n t s
barnastarfs	p a r t n a s t a r f s
barnaverndarnefnd	p a r t n a v E r n t a r n E m t
barnaverndarnefndar	p a r t n a v E r n t a r n E m t a r
barnaverndarstofu	p a r t n a v E r n t a r s t O v Y
barnaverndinni	p a r t n a v E r n t I n I
barndómi	p a r t n_0 t ou m I
barns	p a r_0 s
barnsandlit	p a r_0 s a n t l I t
barnsbeini	p a r_0 s p ei n I
barnsfaðir	p a r_0 s f a D I r
barnsföður	p a r_0 s f 9 D Y r
barnsgrát	p a r_0 s k r au t
barnshafandi	p a r_0 s h a v a n t I
barnsins	p a r_0 s I n s
barnslega	p a r_0 t n s t l E G a
barnslegri	p a r_0 s t l E G r I
barnslegt	p a r_0 s t l E x t
barnslegu	p a r_0 s t l E G Y
barnsmóður	p a r s m ou D Y r
barstólnum	p a: r_0 s t ou l n Y m
baráttumál	p a: r au h t Y m au l
baráttusveitina	p a: r au h t Y s v ei t I n a
baráttuvilja	p a: r au h t Y v I l j a
barþjónn	p a r T j ou t n_0
bassann	p a s a n
baugi	p 9i j I
baðkari	p a D k_h a r I
baðkarinu	p a D k_h a r I n Y
baðkarið	p a D k_h a r I D
baðker	p a D c_h E r
baðkerinu	p a D c_h E r I n Y
baðkerið	p a D c_h E r I D
begga	p E k a
beggu	p E k Y
beinmergs	p ei n m E r k s
beinna	p ei t n a
beinnar	p ei t n a r
beinni	p ei t n I
beint	p ei n_0 t
beinteinn	p ei n t_h ei t n_0
beinvernd	p ei: n v E r n t
beinverndardag	p ei n v E r n t a r t a G
beinverndarsamtakanna	p ei n v E r n t a r s a m t_h a k a n a
bekkinn	p E h c I n
bekkirnir	p E h c I t n I r
bekkja	p E h c a
bekkjarbróðir	p E h c a r p r ou D I r
bekkjarfulltrúa	p E h c a r_0 f Y l_0 t_h r u a
bekkjarsystir	p E h c a r_0 s I s t I r
bekkpressa	p E h k p_h r E s a
beltinu	p E l_0 t I n Y
benedikt	p E: n E t I x t
benedikts	p E: n E t I x t s
benediktsdóttir	p E: n E t I x t s t ou h t I r
benediktsdóttur	p E: n E t I x t s t ou h t Y r
benediktsson	p E: n E t I x t s O n
benediktssonar	p E: n E t I x t s O n a r
benediktssyni	p E: n E t I x t s I n I
bergnuminn	p E r k n Y m I n
bergs	p E r k s
bergsson	p E r k s O n
bergssonar	p E r k s O n a r
bergssyni	p E r k s I n I
bergstallar	p E r k s t a t l a r
bergstein	p E r k s t ei n
bergsteinn	p E r k s t ei t n
bergsveinsson	p E r k s v ei n s O n
bernska	p E r n s k a
bernskuheimili	p E r n s k Y h ei m I l I
berrassaður	p E r a s a D Y r
bessason	p E s a s O n
bessastaðahrepp	p E s a s t a D a r_0 E h p
bessastaðahreppur	p E s a s t a D a r_0 E h p Y r
betlara	p E h t l a r a
beygjurein	p ei j Y r ei n
beygð	p ei G D
beykiinnrétting	p ei: c I I n r j E h t i N k
bifreiðastyrkjum	p I v r ei D a s t I r_0 c Y m
bifvélavirkinn	p I f v j E l a v I r_0 c I n
bikarkeppni	p I: k a r c_h E h p n I
bikarkeppninni	p I: k a r_0 c_h E h p n I n I
biksvart	p I k s v a r_0 t
bilt	p I l_0 t
bindindisfræðslu	p I n t I n t I s f r ai D s t l Y
bindingu	p I n t i N k Y
birginn	p I r c I n
birgðastöðinni	p I r D a s t 9 D I n I
birgðastýring	p I r D a s t i r i N k
birgðir	p I r D I r
birkiplanta	p I r_0 c I h p_h l a n_0 t a
birkitré	p I r_0 c I t_h r j E
birni	p I r t n I
birst	p I r_0 s t
birtingarmynd	p I r_0 t i N k a r m I n t
birtingarskekkja	p I r_0 t i N k a r_0 s c E h c a
birtust	p I r_0 t Y s t
biskupstungum	p I s k Y p s t_h u N k Y m
bissnessmenn	p I s t n E s m E n
bitlausan	p I t l 9i s a n
biturri	p I: t Y r I
bjargvættur	p j a r k v ai h t Y r
bjargvætturinn	p j a r k v ai h t Y r I n
bjarmalands	p j a r m a l a n t s
bjartari	p j a r_0 t a r I
bjartsson	p j a r_0 t s O n
bjartssonar	p j a r_0 t s O n a r
bjartsýn	p j a r_0 t s i n
bjartsýni	p j a r_0 s i n I
bjartsýnir	p j a r_0 t s i n I r
bjartsýnn	p j a r_0 t s i n
bjuggu	p j Y k Y
bjuggum	p j Y k Y m
bjálkabrúna	p j au l_0 k a p r u n a
björgunarskóli	p j 9 r k Y n a r_0 s k ou l I
björgúlfsson	p j 9 r k u l f s O n
björns	p j 9 r_0 s
björnsdóttur	p j 9 r_0 s t ou h t Y r
björnson	p j 9 r_0 s O n
björnssonar	p j 9 r_0 s O n a r
björnssyni	p j 9 r_0 s I n I
bjúgaldin	p j u: G a l t I n
blakta	p l a x t a
blank	p l au N_0 k
blankur	p l au N_0 k Y r
blaðabunki	p l a: D a p u J_0 c I
blaðafulltrúann	p l a: D a f Y t l_0 t_h r u a n
blaðafulltrúi	p l a: D a f Y t l_0 t_h r u I
blaðafulltrúinn	p l a: D a f Y t l_0 t_h r u I n
blaðagreinar	p l a: D a k r ei n a r
blaðamannafundinn	p l a: D a m a n a f Y n t I n
blaðamannapassa	p l a: D a m a n a p_h a s a
bleikja	p l ei: c a
bleikt	p l ei x t
blekking	p l E h c i N k
blekkingar	p l E h c i N k a r
blekkingu	p l E h c i N k Y
blekkingum	p l E h c i N k Y m
blekkjast	p l E h c a s t
bleksprautuprentara	p l E: k s p r 9i t Y p_h r E n_0 t a r a
blessað	p l E s a D
blessaðri	p l E s a D r I
blett	p l E h t
blikkuðu	p l I h k Y D Y
bliss	p l I s
blokk	p l O h k
blokkinni	p l O h c I n I
blossar	p l O s a r
blygðunarlaust	p l I G D Y n a r l 9i s t
blygðunarleysi	p l I G D Y n a r l ei s I
bláminn	p l au: m I n
bláskinssvell	p l au s c I n s v E t l_0
blóraböggulinn	p l ou: r a p 9 k Y l I n
blóðbankinn	p l ou D p au J_0 c I n
blóðhlaupnum	p l ou D l_0 9i h p n Y m
blóðprufunni	p l ou D p_h r Y v Y n I
blóðtappar	p l ou D t_h a h p a r
blússan	p l u s a n
blússu	p l u s Y
blýantana	p l i: a n_0 t a n a
blýantinum	p l i: a n_0 t I n Y m
bogann	p O: G a n
bollason	p O t l a s O n
bolta	p O l_0 t a
boltarugl	p O l_0 t a r Y k l
borgarbókasafnið	p O r k a r p ou k a s a p n I D
borgarfulltrúar	p O r k a r_0 f Y t l_0 t_h r u a r
borgarfulltrúi	p O r k a r f Y t l t r u I
borgarsjóð	p O r k a r_0 s j ou D
borgarstjóri	p O r k a r s t j ou r I
borgarstjórnarkosningar	p O r k a r s t j ou r t n a r k O s t n i N k a r
borgarstjórnarkosningum	p O r k a r_0 s t j ou r t n a r_0 k_h O s t n i N k Y m
borgarverkfræðingi	p O r k a r v E r_0 k f r ai D i J c I
borgarverkfræðings	p O r k a r v E r_0 k f r ai D i N s
borgaryfirvöld	p O r k a r I v I r v 9 l t
bornir	p O r t n I r
borðplötunni	p O r T p_h l 9 t Y n I
bosnía	p O s t n i j a
botninn	p O h t n I n
botnlangi	p O h t n l au J c I
botns	p O s
boxi	p O k s I
bragga	p r a k a
bragganum	p r a k a n Y m
bragðinu	p r a G D I n Y
bragðið	p r a G D I D
brattahlíðarnefnd	p r a h t a l_0 i D a r n E m t
brattar	p r a h t a r
bregða	p r E G D a
bregði	p r E G D I
breiddi	p r ei t I
breiðholtinu	p r ei D h O l_0 t I n Y
breiðholts	p r ei: D h O l_0 t s
breiðholtskirkja	p r ei T O l_0 t s c_h I r_0 c a
breiðholtskirkju	p r ei D h O l_0 t s c_h I r_0 c Y
breiðholtslaug	p r ei D h O l_0 t s t l 9i G
breiðholtsskóla	p r ei D h O l_0 t s k ou l a
breiðumörk	p r ei: D Y m 9 r_0 k
breiðvangi	p r ei D v au J c I
brenglaðar	p r ei N l a D a r
brennd	p r E n t
brenndar	p r E n t a r
brennidepli	p r E n I t E h p l I
brennisteinn	p r E n I s t ei t n_0
bretlandi	p r E: t l a n t I
bretlandsrallinu	p r E t l a n t s r a l I n Y
brettaferð	p r E h t a f E r D
breytingagjald	p r ei: t i N k a c a l t
breytingartillögu	p r ei: t i N k a r t_h I l 9 G Y
breyttra	p r ei h t r a
brjálæðingur	p r j au: l ai D i N k Y r
brjánn	p r j au t n_0
brjóstagjöfum	p r j ou s t a c 9 v Y m
brjóstakrabbameini	p r j ou s t a k_h r a p a m ei n I
brjóstkassa	p r j ou s k_h a s a
broddgöltur	p r O t k 9 l_0 t Y r
broddstafir	p r O t s t a v I r
bronsverðlaun	p r O n s v E r l 9i n
brotnar	p r O h t n a r
brotnað	p r O h t n a D
brotnaði	p r O h t n a D I
brottkasti	p r O h t k_h a s t I
brottkasts	p r O h t k a s t s
bruggað	p r Y k a D
brugðist	p r Y G D I s t
brugðu	p r Y G D Y
brugðust	p r Y G D Y s t
brunablettum	p r Y: n a p l E h t Y m
brunatryggð	p r Y: n a t r I G D
brunna	p r Y n a
bryggjan	p r I c a n
bryggjuhverfi	p r I c Y k_h v E r v I
bryggjuna	p r I c Y n a
bryggjunni	p r I c Y n I
brygði	p r I G D I
brynjólfs	p r I n j ou l f s
brynjólfsson	p r I n j ou l f s O n
brynjólfssonar	p r I n j ou l f s O n a r
brynjúlfsson	p r I n j u l f s O n
brynka	p r i N_0 k a
brynki	p r i J_0 c I
bráðamóttöku	p r au: D a m ou t_h 9 k Y
bræðrafélagið	p r ai D r a f j E l ai j I D
bréfaskriftir	p r j E: v a s k r I f t I r
bréflega	p r j E v l E G a
bréfritarinn	p r j E v r I t a r I n
bréfsnifsinu	p r j E f s t n I f s I n Y
brölta	p r 9 l_0 t a
bröltir	p r 9 l_0 t I r
bröttum	p r 9 h t Y m
brúarfoss	p r u: a r_0 f O s
brúnleitt	p r u n l ei h t
brúðguminn	p r u D k Y m I n
brúðkaupi	p r u D k_h 9i p I
brúðkaupið	p r u D k_h 9i p I D
brúðkaups	p r u D k_h 9i p s
brúðkaupsdaginn	p r u D k_h 9i p s t ai j I n
brúðkaupsferð	p r u D k_h 9i p s f E r D
brúðkaupsnóttina	p r u D k_h 9i p s t n ou h t I n a
brúðkaupsveislu	p r u D k_h 9i p s v ei s t l Y
brúðkaupsþátturinn	p r u D k_h 9i p s T au h t Y r I n
brúðkaupum	p r u D k_h 9i p Y m
brúðubíllinn	p r u: D Y p i t l I n
brýnna	p r i t n a
brýnni	p r i t n I
bubba	p Y p a
buff	p Y f
bumbult	p Y m p Y l_0 t
bunguna	p u N k Y n a
bunka	p u N_0 k a
bunkann	p u N_0 k a n
bunki	p u J_0 c I
bunkinn	p u J_0 c I n
burstar	p Y r_0 s t a r
burstaði	p Y r_0 s t a D I
burtfararprófi	p Y r_0 t f a r a r_0 p_h r ou v I
burtséð	p Y r_0 t s j E D
buxnaklaufina	p Y k s t n a k_h l 9i v I n a
buxum	p Y k s Y m
buxur	p Y k s Y r
bygginga	p I c i N k a
byggingadeild	p I c i N k a t ei l t
byggingaframkvæmdir	p I c i N k a f r a m k_h v ai m t I r
byggingafulltrúa	p I c i N k a f Y t l_0 t_h r u a
bygginganefndar	p I c i N k a n E m t a r
byggingar	p I c i N k a r
byggingarefni	p I c i N k a r E p n I
byggingarframkvæmdir	p I c i N k a r f r a m k_h v ai m t I r
byggingarinnar	p I c i N k a r I n a r
byggingariðnaðarins	p I c i N k a r I D n a D a r I n s
byggingarnefnd	p I c i N k a r n E m t
byggingarnefndarinnar	p I c i N k a r n E m t a r I n a r
byggingin	p I c i J c I n
bygginguna	p I c i N k Y n a
byggir	p I c I r
byggist	p I c I s t
byggjast	p I c a s t
byggð	p I G D
byggða	p I G D a
byggðakvóta	p I G D a k_h v ou t a
byggðamál	p I G D a m au l
byggðarlaga	p I G D a r l a G a
byggðarlaginu	p I G D a r l ai j I n Y
byggðarlagið	p I G D a r l ai j I D
byggðarlög	p I G D a r l 9 G
byggðarlögum	p I G D a r l 9 G Y m
byggðasafn	p I G D a s a p n_0
byggðasafnið	p I G D a s a p n I D
byggðastefnu	p I G D a s t E p n Y
byggðaþróun	p I G D a T r ou Y n
byggðin	p I G D I n
byggðina	p I G D I n a
byggðust	p I G D Y s t
bylgjunni	p I l c Y n I
bylmingshögg	p I l m i N s h 9 k
bylta	p I l_0 t a
byltingin	p I l_0 t i J c I n
byltingunni	p I l_0 t i N k Y n I
byrgðu	p I r D Y
byrjunareinkenni	p I r j Y n a r ei J c_h E n I
byssu	p I s Y
bágt	p au x t
bægja	p ai j a
bæjarbraginn	p ai: j a r p r ai j I n
bæjarfulltrúa	p ai: j a r f Y t l_0 t r u a
bæjarfulltrúar	p ai: j a r_0 f Y l_0 t_h r u a r
bæjarfulltrúi	p ai: j a r f Y t l_0 t r u I
bæjargöngin	p ai: j a r_0 k 9i J c I n
bæjarráði	p ai: j a r au D I
bæjarráðs	p ai: j a r au D s
bæjarstjórnar	p ai: j a r s t j ou r t n a r
bæjarstjórnin	p ai: j a r_0 s t j ou r t n I n
bækling	p ai h k l i N k
bæklingi	p ai h k l i J c I
bæklingnum	p ai h k l i N n Y m
bænamessa	p ai: n a m E s a
bættri	p ai h t r I
bíddu	p i t Y
bíldshöfða	p i l t s h 9 v D a
bílgluggann	p i l k l Y k a n
bítlanna	p i h t l a n a
bíóhöllin	p i: ou h 9 t l I n
bóasdóttir	p ou: a s t ou h t I r
bófarnir	p ou: v a r t n I r
bóginn	p ou j I n
bókasafnið	p ou: k a s a p n I D
bókasafns	p ou: k a s a p n_0 s
bókasöfnum	p ou: k a s 9 p n Y m
bókmenntanna	p ou: k m E n_0 t a n a
bókmenntum	p ou k m E n_0 t Y m
bókstaflegri	p ou k s t a v l E G r I
bólgnar	p ou l n a r
bólgnir	p ou l n I r
bólgusjúkdóma	p ou l k Y s j u k t ou m a
bólugrafinn	p ou: l Y k r a v I n
bólusótt	p ou: l Y s ou h t
böggum	p 9 k Y m
bökkum	p 9 h k Y m
búinn	p u: I n
búkar	p u: k a r
búkollu	p u: k_h O t l Y
búnaðarbankann	p u: n a D a r p au N_0 k a n
búnaðarbankans	p u: n a D a r p au N_0 k a n s
búnaðarbanki	p u: n a D a r p au J_0 c I
búningnum	p u: n i N n Y m
búningsherbergi	p u: n i N s h E r p E r c I
búningsherberginu	p u: n i N s h E r p E r c I n Y
bústaðakirkja	p u s t a D a c_h I r_0 c a
búðarklettur	p u: D a r_0 k_h l E h t Y r
búðarsveinninn	p u: D a r s v ei t n I n
dabbi	t a p I
daddi	t a t I
dagbjartsdóttir	t a G p j a r_0 t s t ou h t I r
dagbjartsson	t a G p j a r_0 t s O n
dagbjartur	t a G p j a r_0 t Y r
daginn	t ai j I n
daglegra	t a G l E G r a
dagmömmunnar	t a G m 9 m Y n a r
dags	t a x s
dagsbirtan	t a x s p I r_0 t a n
dagsdóttir	t a x s t ou h t I r
dagsetningar	t a x s E h t n I N k a r
dagsetninguna	t a x s E h t n I N k Y n a
dagskrárnefndinni	t a x s k r au r n E m t I n I
dagurinn	t a: G Y r I n
dagvaktinni	t a G v a x t I n I
dalabyggð	t a: l a p I G D
dallinn	t a t l I n
dalvíkurbyggðar	t a l v i k Y r p I G D a r
dampi	t a m_0 p I
dangla	t au N l a
danglaði	t au N l a D I
dansflokksins	t a n s f l O h k s I n s
dansiböllum	t a n s I p 9 l Y m
danskt	t a n s t
dansnótta	t a n s t n ou h t a
daníelsdóttir	t a: n i j E l s t ou h t I r
daprir	t a: p r I r
dapurt	t a: p Y r_0 t
dauðadrukkinn	t 9i: D a t r Y h c I n
dauðhræddur	t 9i D r_0 ai t Y r
dauðlangar	t 9i D l au N k a r
davíðsdóttir	t a: v i D s t ou h t I r
debetkortareikning	t E: p E t k_h O r_0 t a r ei h k n i N k
degi	t ei: j I
deginum	t ei j I n Y m
deildabikarkeppni	t ei l t a p I k a r c_h E h p n I
deildarforseti	t ei l t a r_0 f O r_0 s E t I
deildarkeppninni	t ei l t a r_0 c_h E h p n I n I
deildaskipting	t ei l t a s c I f t i N k
deildstjóra	t ei l t s t j ou r a
deiliskipulagi	t ei: l I s c I p Y l ai j I
dekkið	t E h c I D
dekkjaýlfri	t E h c a i l v r I
dekkjum	t E h c Y m
dekkjunum	t E h c Y n Y m
dekkri	t E h k r I
dekurrófu	t E: k Y r ou v Y
delinn	t E: l I n
dembdi	t E m t I
dempun	t E m_0 p Y n
derhúfu	t E r h u v Y
detta	t E h t a
diddu	t I t Y
digraneskirkju	t I G r a n E s c_h I r_0 c Y
digranesvegi	t I G r a n E s v ei j I
dimma	t I m a
dimmaturni	t I m a t_h Y r t n I
dimmraddaður	t I m r a t a D Y r
dimmuna	t I m Y n a
dingla	t i N l a
dinglaðu	t i N l a D Y
diplóma	t I h p l ou m a
dirfðist	t I r D I s t
djamm	t j a m
djamma	t j a m a
djarfara	t j a r v a r a
djarflega	t j a r f l E G a
djassins	t j a s I n s
djöflapresti	t j 9 p l a p_h r E s t I
djúpi	t j u: p I
djúpsteiktir	t j u p s t ei x t I r
djúpsteiktur	t j u p s t ei x t Y r
djúpur	t j u: p Y r
djúpver	t j u: p v E r
djúpvirkandi	t j u: p v I r_0 k a n t I
dofinn	t O: v I n
doktorsnám	t O x t O r_0 s t n au m
doktorsprófi	t O x t O r_0 s p_h r ou v I
doktorsritgerð	t O x t O r_0 s r I t c E r D
dollar	t O l a r
dollarinn	t O l a r I n
dollurum	t O l O r Y m
dollý	t O l i
dottað	t O h t a D
drafaði	t r a: v a D I
dragið	t r ai j I D
dragt	t r a x t
dragtina	t r a x t I n a
dramatískt	t r a: m a t_h i s t
drangsnesinga	t r au N s t n E s i N k a
draugagang	t r 9i: G a k au N k
draugalegt	t r 9i: G a l E x t
draugurinn	t r 9i: G Y r I n
dreift	t r ei f t
drekinn	t r E: c I n
drekki	t r E h c I
drekkið	t r E h c I D
drekkt	t r E x t
drekkti	t r E x t I
drekkum	t r E h k Y m
dreng	t r ei N k
drenghnokka	t r ei N k n_0 O h k a
drengir	t r ei J c I r
drengjasveit	t r ei J c a s v ei t
drengnum	t r ei N n Y m
drengsins	t r ei N s I n s
drepnir	t r E h p n I r
drifkraftur	t r I v k_h r a f t Y r
drjúgt	t r j u x t
drjúgum	t r j u: G Y m
drottningu	t r O h t n i N k Y
drottningunni	t r O h t n i N k Y n I
drukkin	t r Y h c I n
drukkið	t r Y h c I D
drukknað	t r Y h k n a D
drukknaður	t r Y h k n a D Y r
drukknir	t r Y h k n I r
drullupirruð	t r Y t l Y p_h I r Y D
drullusokkur	t r Y t l Y s O h k Y r
drullusokkurinn	t r Y t l Y s O h k Y r I n
drungalegri	t r u N k a l E G r I
druslunni	t r Y s t l Y n I
drykki	t r I h c I
drykkina	t r I h c I n a
drykkja	t r I h c a
drykkjar	t r I h c a r
drykkju	t r I h c Y
drykkjufélaga	t r I h c Y f j E l a G a
drykkjunni	t r I h c Y n I
drykkurinn	t r I h k Y r I n
dráttarpakka	t r au h t a r p a h k a
dráttarvexti	t r au h t a r v E k s t I
drúpti	t r u f t I
dufgussonum	t Y f k Y s O n Y m
duftið	t Y f t I D
duglegt	t Y G l E x t
dularfullt	t Y: l a r f Y l_0 t
dulfræðilega	t Y l f r ai D I l E G a
dulspekikokkurinn	t Y l s p E c I k_h O h k Y r I n
dunkinn	t u J_0 c I n
dunkinum	t u J_0 c I n Y m
dvalarstað	t v a: l a r_0 s t a D
dvergsmáum	t v E r k s m au Y m
dyflinar	t I p l I n a r
dyggan	t I k a n
dyggri	t I k r I
dyggur	t I k Y r
dyggð	t I G D
dyggðir	t I G D I r
dynki	t i J_0 c I
dynkir	t i J_0 c I r
dyrakarminum	t I: r a k_h a r m I n Y m
dytti	t I h t I
dálitlum	t au: l I h t l Y m
dálkasentimetra	t au l_0 k a s E n_0 t I m E t r a
dásamlegt	t au: s a m l E x t
dægrastyttingu	t ai G r a s t I h t i N k Y
dægurbaráttunni	t ai: G Y r p a r au h t Y n I
dívaninn	t i: v a n I n
dómaranefndar	t ou: m a r a n E m t a r
dómkirkjuna	t ou m c_h I r_0 c Y n a
dómkirkjunnar	t ou m c_h I r_0 c Y n a r
dómkirkjunni	t ou m c_h I r_0 c Y n I
dómkirkjuprestur	t ou m c_h I r_0 c Y p_h r E s t Y r
dómkirkjutorgið	t ou: m c_h I r_0 c Y t_h O r c I D
dómkórinn	t ou m k_h ou r I n
dómnefndarinnar	t ou m n E m t a r I n a r
dómnefndinni	t ou m n E m t I n I
dómpapinn	t ou m p_h a p I n
dómsmálaráðherrann	t ou m s m au l a r au T h E r a n
dópið	t ou: p I D
dótturdóttur	t ou h t Y r_0 t ou h t Y r
dótturfélag	t ou h t Y r f j E l a G
dótturinnar	t ou h t Y r I n a r
dökkblá	t 9 h k p l au
dökkblár	t 9 h k p l au r
dökkbrún	t 9 h k p r u n
dökkgrár	t 9 h k r au r
dökkjarpt	t 9 h c a r_0 t
dökknaði	t 9 h k n a D I
dúfurnar	t u: v Y r t n a r
dúkkar	t u h k a r
dúnfyllingin	t u n f I t l i J c I n
dúnkenndum	t u J c_h E n t Y m
dýflissu	t i f l I s Y
dýptarskerpa	t i f t a r_0 s c E r_0 p a
dýrafirði	t i: r a f I r D I
dýragarðinum	t i: r a k a r D I n Y m
dýralæknirinn	t i: r a l ai h k n I r I n
dýraverndunarfélag	t i: r a v E r n t Y n a r_0 f j E l a G
dýrlega	t i r l E G a
dýrlingurinn	t i r l i N k Y r I n
dýrsins	t i r_0 s I n s
efahyggjumanninum	E: v a h I c Y m a n I n Y m
eff	E f
efldi	E l t I
efldist	E l t I s t
efnafræðilega	E p n a f r ai D I l E G a
efnahagslegan	E p n a h a x s t l E G a n
efnahagslegra	E p n a h a x s t l E G r a
efnahagslegu	E p n a h a x s t l E G Y
efnahagsmálum	E p n a h a x s m au l Y m
efnahagsnefndar	E p n a h a x s t n E m t a r
efnahagsreikningi	E p n a h a x s r ei h k n i J c I
efnaskiptasjúkdóma	E p n a s c I f t a s j u k t ou m a
efnaskiptum	E p n a s c I f t Y m
efnaverksmiðju	E p n a v E r_0 k s m I D j Y
efndi	E m t I
efndu	E m t Y
efnilega	E p n I l E G a
efnisins	E p n I s I n s
efniskránni	E p n I s k r au n I
efnislega	E p n I s t l E G a
efnislegum	E p n I s t l E G Y m
efnistöku	E p n I s t_h 9 k Y
efnistökum	E p n I s t_h 9 k Y m
efnisval	E p n I s v a l
efnisvali	E p n I s v a l I
efnisvísar	E p n I s v i s a r
efniviðurinn	E p n I v I D Y r I n
efnt	E m_0 t
efsta	E f s t a
eftirbreytni	E f t I r p r ei h t n I
eftirdragi	E f t I r_0 t r ai j I
eftirfarandi	E f t I r f a r a n t I
eftirfylgni	E f t I r f I l n I
eftirförinni	E f t I r_0 f 9 r I n I
eftirgrennslan	E f t I r k r E n s t l a n
eftirlaun	E f t I r l 9i n
eftirlaunum	E f t I r l 9i n Y m
eftirliti	E f t I r l I t I
eftirlitsferð	E f t I r l I t s f E r D
eftirlíkingar	E f t I r l i c i N k a r
eftirmat	E f t I r m a t
eftirminnilegri	E f t I r m I n I l E G r I
eftirminnilegt	E f t I r m I n I l E x t
eftirminnilegum	E f t I r m I n I l E G Y m
eftirmála	E f t I r m au l a
eftirnafn	E f t I r n a p n_0
eftirréttinn	E f t I r j E h t I n
eftirrétturinn	E f t I r j E h t Y r I n
eftirsjáin	E f t I r s j au I n
eftirsjár	E f t I r_0 s j au r
eftirstríðsáranna	E f t I r_0 s t r i D s au r a n a
eftirsótta	E f t I r_0 s ou h t a
eftirtalin	E f t I r_0 t_h a l I n
eftirtekt	E f t I r_0 t_h E x t
eftirtöldum	E f t I r_0 t_h 9 l t Y m
eftirvögnum	E f t I r v 9 k n Y m
eggerts	E c E r_0 t s
eggertsdóttir	E c E r_0 s t ou h t I r
eggertsdóttur	E c E r_0 t s t ou h t Y r
eggertsson	E c E r_0 t s O n
eggheimta	E k h ei m_0 t a
eggi	E c I
eggin	E c I n
egginu	E c I n Y
eggið	E c I D
eggja	E c a
eggjandi	E c a n t I
eggjum	E c Y m
egilsstaða	ei j I l s t a D a
egyptalandi	E: c I f t a l a n t I
eigendaskipti	ei: G E n t a s c I f t I
eiginfjárhlutfallið	ei j I n f j au r l_0 Y t f a t l I D
eiginkona	ei j I n k_h O n a
eiginkonan	ei j I n k_h O n a n
eiginkonu	ei j I n k_h O n Y
eiginkonunnar	ei j I n k_h O n Y n a r
eiginkonunni	ei j I n k_h O n Y n I
eiginkonur	ei j I N k_h O n Y r
eiginkonurnar	ei j I n k_h O n Y r t n a r
eiginlegri	ei j I n l E G r I
eignarhaldsfélagið	ei k n a r_0 h a l t s f j E l ai j I D
eignarrétt	ei k n a r j E h t
eignarrétti	ei k n a r j E h t I
eignarréttindi	ei k n a r j E h t I n t I
eignarskatt	ei k n a r_0 s k a h t
eignarskattur	ei k n a r_0 s k a h t Y r
eilífur	ei: l i v Y r
eimskipafélaginu	ei m s c I p a f j E l ai j I n Y
eimskipafélags	ei m s c I p a f j E l a x s
eimskipafélagsins	ei m s c I p a f j E l a x s I n s
einangra	ei: n au N k r a
einangrunar	ei: n au N k r Y n a r
einarðlega	ei: n a r D l E G a
einbeitti	ei n p ei h t I
eindregið	ei n t r ei j I D
eindálki	ei n t au l_0 c I
eineggja	ei: n E c a
einhuga	ei n h Y G a
einhverntíma	ei N_0 k v E t n_0 t_h i m a
einhverrar	ei N_0 k_h v E r a r
einhvert	ei N_0 k v E r_0 t
eining	ei: n i N k
einkaaðilar	ei N_0 k a a D I l a r
einkaaðilum	ei N_0 k a a D I l Y m
einkaeign	ei N_0 k a ei k n_0
einkaeignarrétti	ei N_0 k a ei k n a r j E h t I
einkaeigu	ei N_0 k a ei G Y
einkafyrirtæki	ei N k_h a f I r I r_0 t_h ai c_h I
einkafyrirtækja	ei N_0 k a f I r I r t_h ai c a
einkafyrirtækjum	ei N_0 k a f I r I r_0 t_h ai c Y m
einkageiranum	ei N k_h a c ei r a n Y m
einkaherbergi	ei N k_h a h E r p E r c I
einkalífi	ei N_0 k a l i v I
einkalífinu	ei N_0 k a l i v I n Y
einkalífið	ei N_0 k a l i v I D
einkamálum	ei N_0 k a m au l Y m
einkaneyslu	ei N_0 k a n ei s t l Y
einkanlega	ei N_0 k a n l E G a
einkanota	ei N_0 k a n O t a
einkar	ei N_0 k a r
einkarekinna	ei N_0 k a r E c I n a
einkareknu	ei N_0 k a r E h k n Y
einkareknum	ei N_0 k a r E h k n Y m
einkarekstri	ei N_0 k a r E k s t r I
einkarétt	ei N_0 k a r j E h t
einkasala	ei N_0 k a s a l a
einkaskóla	ei N_0 k a s k ou l a
einkaspæjari	ei N_0 k a s p ai j a r I
einkasölu	ei N_0 k a s 9 l Y
einkasýning	ei N_0 k a s i n i N k
einkasýningu	ei N_0 k a s i n i N k Y
einkavæða	ei N_0 k a v ai D a
einkavæðingar	ei N_0 k a v ai D i N k a r
einkavæðingu	ei N_0 k a v ai D i N k Y
einkenna	ei J c_h E n a
einkennandi	ei J c_h E n a n t I
einkennast	ei J c_h E n a s t
einkenndi	ei J c_h E n t I
einkenndist	ei J c_h E n t I s t
einkennilegar	ei J c_h E n I l E G a r
einkennilegt	ei J c_h E n I l E x t
einkennin	ei J c_h E n I n
einkennir	ei J c_h E n I r
einkennisbúning	ei J c_h E n I s p u n i N k
einkennisbúninga	ei J c_h E n I s p u n i N k a
einkennisbúningi	ei J c_h E n I s p u n i J c I
einkennisbúninginn	ei J c_h E n I s p u n i J c I n
einkennisklæddir	ei J c_h E n I s k_h l ai t I r
einkennisklæddur	ei J c_h E n I s k l ai t Y r
einkennissmellu	ei J c_h E n I s m E t l Y
einkennisstafina	ei J c_h E n I s t a v I n a
einkennist	ei J c_h E n I s t
einkennt	ei J c_h E n_0 t
einkennum	ei J c_h E n Y m
einkunnarorð	ei N_0 k Y n a r O r D
einkunnina	ei N_0 k Y n I n a
einkunnir	ei N_0 k Y n I r
einkunnum	ei N_0 k Y n Y m
einlægt	ei n l ai x t
einn	ei t n_0
einna	ei t n a
einnar	ei t n a r
einni	ei t n I
einnig	ei t n I G
einnota	ei n O t a
einræktun	ei n r ai x t Y n
einstaklingar	ei n s t a h k l i N k a r
einstaklingum	ei n s t a h k l i N k Y m
einstakra	ei n s t a k r a
einstæðingsskap	ei n s t ai D i N s k a p
einsöngvara	ei n s 9i N k v a r a
einsöngvurum	ei n s 9i N k v Y r Y m
eintaka	ei n t_h a k a
eintómt	ei n t_h ou m_0 t
eintölu	ei n t_h 9 l Y
einungis	ei: n u J c I s
eistlendinganna	ei s t l E n t i N k a n a
eitra	ei: t r a
ekkann	E h k a n
ekkasogin	E h k a s Oi j I n
ekki	E h c I
ekkju	E h c Y
ekkjukrossinn	E h c Y k_h r O s I n
ekkjum	E h c Y m
ekkjunni	E h c Y n I
ekkjur	E h c Y r
ektakvinnu	E x t a k_h v I n Y
eldflaug	E l t f l 9i G
eldhússins	E l t h u s I n s
eldhússtrompinn	E l t h u s t r O m_0 p I n
eldhúsvaskinum	E l t h u s v a s c I n Y m
eldjárn	E l t j au r t n_0
eldjárns	E l t j au r_0 s
elds	E l t s
eldsins	E l t s I n s
eldsneyti	E l t s t n ei t I
eldsneytisgeymir	E l t s t n ei t I s c ei m I r
eldsneytisverð	E l t s t n ei t I s v E r D
eldspýtum	E l t s p i t Y m
eldspýtuna	E l t s p i t Y n a
eldspýtunni	E l t s p i t Y n I
eldspýtustokk	E l t s p i t Y s t O h k
eldstöðvum	E l t s t 9 D v Y m
eldsvoða	E l t s v O D a
eldveggur	E l t v E k Y r
eldvirkni	E l t v I r_0 k n I
eldvörpu	E l t v 9 r_0 p Y
ella	E l a
ellefti	E t l E f t I
elleftu	E t l E f t Y
ellefu	E t l E v Y
ellertsson	E l E r_0 t s O n
ellingsen	E l i N s E n
elliðavatni	E t l I D a v a h t n I
elliðavatns	E t l I D a v a s
elska	E l s k a
elskan	E l s k a n
elskulegrar	E l s k Y l E G r a r
eltast	E l_0 t a s t
eltist	E l_0 t I s t
eltu	E l_0 t Y
elíassonar	E: l i j a s O n a r
embættismanna	E m p ai h t I s m a n a
embættisverk	E m p ai h t I s v E r_0 k
emma	E m a
endasleppt	E n t a s t l E f t
endilöng	E n t I l 9i N k
endurbyggja	E n t Y r p I c a
endurflutt	E n t Y r f l Y h t
endurgjalds	E n t Y r_0 c a l t s
endurhæfingar	E n t Y r h ai v i N k a r
endurkjöri	E n t Y r_0 c_h 9 r I
endurlausnarkirkjunni	E n t Y r l 9i s t n a r c_h I r_0 c Y n I
endurlifir	E n t Y r l I v I r
endurminningar	E n t Y r m I n i N k a r
endurnærandi	E n t Y r n ai r a n t I
endurreist	E n t Y r ei s t
endurræsingu	E n t Y r ai s i N k Y
endursegja	E n t Y r s ei j a
endurskilgreiningar	E n t Y r_0 s c I l k r ei n i N k a r
endurskipulagning	E n t Y r s c I p Y l a k n i N k
endurskipulagningar	E n t Y r_0 s c I p Y l a k n i N k a r
endurskipuleggja	E n t Y r_0 s c I p Y l E c a
endurskoða	E n t Y r_0 s k O D a
endurskoðun	E n t Y r_0 s k O D Y n
endurskoðunar	E n t Y r_0 s k O D Y n a r
endurskoðunarstaðlar	E n t Y r_0 s k O D Y n a r_0 s t a D l a r
endursýndur	E n t Y r_0 s i n t Y r
endurvinnslustöðvar	E n t Y r v I n s t l Y s t 9 D v a r
engann	ei N k a n
engar	ei N k a r
engdist	ei N t I s t
engdust	ei N t Y s t
engey	ei J c ei
engi	ei J c I
engiferi	ei J c I f E r I
engilberts	ei J c I l p E r_0 t s
engilbertsdóttir	ei J c I l p E r_0 t s t ou h t I r
engill	ei J c I t l_0
enginn	ei J c I n
engisprettur	ei J c I s p r E h t Y r
engið	ei J c I D
engla	ei N l a
englaborg	ei N l a p O r k
england	ei N l a n t
englandsmeistaratitil	ei N l a n t s m ei s t a r a t_h I t I l
englanna	ei N l a n a
englendinga	ei N l E n t i N k a
englendingar	ei N l E n t i N k a r
englendinginn	ei N l E n t i J c I n
englendingsins	ei N l E n t i N s I n s
englendingum	ei N l E n t i N k Y m
englendingurinn	ei N l E n t i N k Y r I n
engli	ei N l I
englum	ei N l Y m
englunum	ei N l O n Y m
engrar	ei N k r a r
engu	ei N k Y
enskt	E n s t
eplatré	E h p l a t_h r j E
erfidrykkju	E r v I t r I h c Y
erfiðisvinnu	E r v I D I s v I n Y
erft	E r_0 t
erfðabreytt	E r D a p r ei h t
erfðaefni	E r D a E p n I
erfðaefnis	E r D a E p n I s
erfðafylgni	E r D a f I l k n I
erfðagreiningar	E r D a k r ei n i N k a r
erfðagreiningu	E r D a k r ei n i N k Y
erfðarannsókn	E r D a r a n s ou h k n_0
erfðaskrá	E r D a s k r au
erfðaskráin	E r D a s k r au I n
erfðaskrána	E r D a s k r au n a
erfði	E r D I
ergilegt	E r c I l E x t
erlendrar	E r l E n t r a r
erlingsdóttir	E r l i N s t ou h t I r
ernst	E r n s t
erpur	E r_0 p Y r
esjuhlíðar	E: s j Y l_0 i D a r
evangelísk	E: v a J c E l i s k
everestfjall	E: v E r E s t f j a t l_0
evrusvæðinu	E v r Y s v ai D I n Y
evrópskra	E v r ou p s k r a
evrópskt	E v r ou p s t
evrópubúar	E v r ou p Y p u a r
evrópukeppni	E v r ou p Y c_h E h p n I
evrópuríkja	E v r ou p Y r i c a
evrópuríkjum	E v r ou p Y r i c Y m
evrópuþingið	E v r ou p Y T i J c I D
evrópuþingsins	E v r ou p Y T i N s I n s
exi	E k s I
eyddi	ei t I
eyjamanna	ei j a m a n a
eyjarskeggjar	ei: j a r_0 s c E c a r
eyjastelpu	ei: j a s t E l_0 p Y
eyjastúlkur	ei: j a s t u l_0 k Y r
eyjólfs	ei: j ou l f s
eyjólfsdóttir	ei j ou l f s t ou h t I r
eyjólfssonar	ei: j ou l f s O n a r
eyjólfsstaðir	ei: j ou l f s t a D I r
eyjólfssyni	ei: j ou l f s I n I
eynni	ei n I
eyrinni	ei: r I n I
eyrnamerktur	ei r t n a m E r_0 t Y r
eysteinn	ei: s t ei t n_0
eystrasaltsríkin	ei s t r a s a l_0 t s r i c I n
eystribyggð	ei s t r I p I G D
eyðilagt	ei: D I l a x t
eyðilegt	ei: D I l E x t
eyðslu	ei D s t l Y
eðvaldsson	E D v a l t s O n
fagfjárfestasjóðurinn	f a x f j au r f E s t a s j ou D Y r I n
faginu	f ai j I n Y
faglegt	f a G l E x t
fagrahvammi	f a G r a k_h v a m I
fagrar	f a G r a r
fagtengdar	f a G t_h ei N t a r
fagtengdi	f a x t_h ei N t I
faldir	f a l t I r
fall	f a t l_0
falla	f a t l a
fallegastur	f a t l E G a s t Y r
fallegi	f a t l ei j I
fallinu	f a t l I n Y
fallorð	f a t l O r D
falls	f a l s
fallsins	f a t l s I n s
falsað	f a l s a D
falskt	f a l s t
fangaklefa	f au N k a k_h l E v a
fangana	f au N k a n a
fangann	f au N k a n
fangavagninum	f au N k a v a k n I n Y m
fangavörðurinn	f au N k a v 9 r D Y r I n
fangelsi	f au J c E l s I
fangelsisvistar	f au J c E l s I s v I s t a r
fangelsum	f au J c E l s Y m
fanghlutfallið	f au n k l_0 Y t f a t l I D
fanginni	f au J c I n I
fann	f a n
fannst	f a n s t
fantasíu	f a n_0 t a s i j Y
fantur	f a n_0 t Y r
far	f a: r
fararsnið	f a: r a r s t n I D
fararstjóra	f a: r a r_0 s t j ou r a
fargjöld	f a r c 9 l t
farnir	f a r t n I r
farsælt	f a r_0 s ai l_0 t
farsímanum	f a r_0 s i m a n Y m
fartölvum	f a r_0 t_h 9 l v Y m
farvegi	f a r v ei j I
farþegasætinu	f a r T E G a s ai t I n Y
fasmikill	f a s m I c I t l_0
fatakynningu	f a: t a c_h I n i N k Y
fataskipti	f a: t a s c I f t I
fatlað	f a h t l a D
fatnaði	f a h t n a D I
fax	f a k s
faxaflói	f a k s a f l ou I
faðmlagi	f a D m l ai j I
faðmlagið	f a D m l ai j I D
fegin	f ei j I n
feginsamlega	f ei j I n s a m l E G a
fegnir	f ei k n I r
fegurstu	f E: G Y r_0 s t Y
fegurðarsamkeppni	f E: G Y r D a r_0 s a m c_h E h p n I
feikilega	f ei: c I l E G a
feikna	f ei h k n a
feitir	f ei: t I r
feitlaginn	f ei t l ai j I n
feldspat	f E l t s p a t
feldur	f E l t Y r
fellsbrotið	f E l s p r O t I D
fellst	f E l s t
fellt	f E l_0 t
felmtruð	f E l m_0 t r Y D
fenginn	f ei J c I n
fengju	f ei J c Y
fengjust	f ei J c Y s t
fengnar	f ei N n a r
fengnir	f ei N n I r
fengnum	f ei N n Y m
fenguð	f ei N k Y D
ferflötungar	f E r_0 f l 9 t u N k a r
ferhyrnd	f E r h I n t
ferhyrndur	f E: r_0 h I r n t Y r
ferhyrnt	f E: r h I n_0 t
ferlegt	f E r l E x t
ferlinum	f E r t l I n Y m
fermdur	f E r m t Y r
fermingarmessa	f E r m i N k a r m E s a
fermingarpeningunum	f E r m i N k a r_0 p_h E n i N k O n Y m
fernt	f E n_0 t
ferska	f E r_0 s k a
ferskir	f E r_0 s c I r
ferskleika	f E r_0 s k l ei k a
fersksíldar	f E r_0 s k s i l t a r
fersku	f E r_0 s k Y
ferst	f E r_0 s t
fertugasta	f E r_0 t Y G a s t a
fertugasti	f E r_0 t Y G a s t I
ferðafélagi	f E r D a f j E l ai j I
ferðafólki	f E r D a f ou l_0 c I
ferðalagi	f E r D a l ai j I
ferðalaginu	f E r D a l ai j I n Y
ferðalögin	f E r D a l 9i j I n
ferðamálafulltrúi	f E r D a m au l a f Y t l t_h r u I
ferðaskrifstofur	f E r D a s k r I f s t O v Y r
ferðatösku	f E r D a t_h 9 s k Y
fetum	f E: t Y m
feykisterkt	f ei: c I s t E r_0 t
fiffar	f I f a r
filippseyjum	f I: l I p s ei j Y m
filippusdóttur	f I: l I h p Y s t ou h t Y r
fim	f I: m
fimlega	f I m l E G a
fimleikadeild	f I m l ei k a t ei l t
fimleikakeppni	f I m l ei k a c_h E h p n I
fimm	f I m
fimmgangur	f I m k au N k Y r
fimmhundruð	f I m h Y n t r Y D
fimmstæð	f I m s t ai D
fimmtudag	f I m_0 t Y t a G
fimmtudagsmorgnum	f I m_0 t Y t a x s m O r t n Y m
fimmtugasta	f I m_0 t Y G a s t a
fimmtungur	f I m_0 t u N k Y r
fimmtándi	f I m_0 t au n t I
fimmtíukall	f I m_0 t i j Y k_h a t l_0
fingrunum	f i N k r O n Y m
fingurgóma	f i N k Y r_0 k ou m a
fingurkoss	f i N k Y r_0 k_h O s
finnbjörnsson	f I n p j 9 r_0 s O n
finnbogadóttir	f I n p O G a t ou h t I r
finnbogadóttur	f I m p O G a t ou h t Y r
finnsdóttir	f I n s t ou h t I r
fiskimjölsverksmiðjunnar	f I s c I m j 9 l s v E r_0 k s m I D j Y n a r
fiskimjölsverksmiðjur	f I s c I m j 9 l s v E r_0 k s m I D j Y r
fiskimálum	f I s c I m au l Y m
fiskinnflytjandinn	f I s c I n f l I t j a n t I n
fiskistofnanna	f I s c I s t O p n a n a
fiskpinna	f I s k p_h I n a
fisks	f I s k s
fisksins	f I s k s I n s
fisktegundinni	f I s k t_h E G Y n t I n I
fisktegundir	f I s k t_h E G Y n t I r
fiskveiðistefna	f I s k v ei D I s t E p n a
fiskveiðistjórn	f I s k v ei D I s t j ou r t n_0
fiskvinnslu	f I s k v I n s t l Y
fitjaði	f I: t j a D I
fitla	f I h t l a
fiðlusnillingsins	f I D l Y s t n I t l i N s I n s
fiðursæng	f I: D Y r s ai N k
fjalla	f j a t l a
fjallakjóa	f j a t l a c_h ou a
fjallgöngumanna	f j a t l_0 k 9i N k Y m a n a
fjallkonuna	f j a t l k_h O n Y n a
fjalls	f j a t l s
fjallshlíð	f j a l s l_0 i D
fjallshlíðum	f j a l s l_0 i D Y m
fjallsins	f j a l s I n s
fjallsmynni	f j a l s m I n I
fjallstindinum	f j a l s t_h I n t I n Y m
fjarkennsla	f j a: r c_h E n s t l a
fjarlægri	f j a r l ai G r I
fjarlægt	f j a r l ai x t
fjarlægð	f j a r l ai G D
fjarlægðar	f j a r l ai G D a r
fjarlægðinni	f j a r l ai G D I n I
fjarrænn	f j a r ai t n_0
fjarska	f j a r_0 s k a
fjarskalega	f j a r_0 s k a l E G a
fjarskiptafyrirtæki	f j a r_0 s c I f t a f I r I r_0 t_h ai c I
fjarskiptafyrirtækið	f j a r_0 s c I f t a f I r I r t_h ai c I D
fjarskiptafyrirtækjum	f j a r_0 s c I f t a f I r I r t_h ai c Y m
fjarskiptakerfi	f j a r_0 s c I f t a c_h E r v I
fjarskiptamarkaði	f j a r_0 s c I f t a m a r_0 k a D I
fjarskiptasambandsins	f j a r_0 s c I f t a s a m p a n t s I n s
fjarskiptastofnun	f j a r_0 s c I f t a s t O p n Y n
fjarskiptastofnunar	f j a r_0 s c I f t a s t O p n Y n a r
fjarskiptatækni	f j a r_0 s c I f t a t_h ai h k n I
fjarskiptum	f j a r_0 s c I f t Y m
fjarstöddum	f j a r_0 s t 9 t Y m
fjarstýring	f j a r_0 s t i r i N k
fjarstýringuna	f j a r_0 s t i r i N k Y n a
fjarsöluhugtaksins	f j a r_0 s 9 l Y h Y x t_h a k s I n s
fjarðarbyggð	f j a r D a r p I G D
fjeldsted	f j E l s t E t
fjárfestingaeignir	f j au r_0 f E s t i N k a ei k n I r
fjárfestingar	f j au r_0 f E s t i N k a r
fjárfestingarbanka	f j au r f E s t i N k a r p au N_0 k a
fjárkúgun	f j au r_0 k_h u G Y n
fjárlagafrumvarpi	f j au r l a G a f r Y m v a r_0 p I
fjárlagafrumvarpið	f j au r l a G a f r Y m v a r_0 p I D
fjárlagafrumvarpsins	f j au r l a G a f r Y m v a r_0 p s I n s
fjárlaganefnd	f j au r l a G a n E m t
fjármagns	f j au r m a k n_0 s
fjármagnsgjöld	f j au r m a k n_0 s c 9 l D
fjármagnshreyfingum	f j au r m a k n_0 s r_0 ei v i N k Y m
fjármagnskostnað	f j au r m a k n_0 s k_h O s t n a D
fjármagnskostnaður	f j au r m a x s k_h O s t n a D Y r
fjármagnsliði	f j au r m a k n_0 s t l I D I
fjármagnsmarkaði	f j au r m a k n_0 s m a r_0 k a D I
fjármagnstekjur	f j au r m a k n_0 s t_h E c Y r
fjármálakreppu	f j au r m au l a k_h r E h p Y
fjármálalegum	f j au r m au l a l E G Y m
fjármálaráðherra	f j au r m au l a r au T h E r a
fjármálaráðherrann	f j au r m au l a r au D h E r a n
fjárskorts	f j au r_0 s k O r_0 t s
fjær	f j ai: r
fjórgangur	f j ou r k au N k Y r
fjórskiptan	f j ou r_0 s c I f t a n
fjórtándi	f j ou r_0 t au n t I
fjórðungi	f j ou r D u J c I
fjórðungur	f j ou r D u N k Y r
fjögurleytið	f j 9: G Y r l ei t I D
fjölbreytileiki	f j 9 l p r ei t I l ei c I
fjölbreytnina	f j 9 l p r ei h t n I n a
fjölbýlishúsum	f j 9: l p i l I s h u s Y m
fjölmiðlafrumvarpið	f j 9 l m I D l a f r Y m v a r_0 p I D
fjölnismenn	f j 9 l n I s m E n
fjölorkuvélum	f j 9: l O r_0 k Y v j E l Y m
fjölskyldumaður	f j 9 l s c I l t Y m a D Y r
fjölskyldumorgnar	f j 9 l s c I l t Y m O r t n a r
fjölskyldusamkoma	f j 9 l s c I l t Y s a m k_h O m a
fjölskylduskrifstofu	f j 9 l s c I l t Y s k r I f s t O v Y
fjöltækni	f j 9 l t_h ai h k n I
fjölvöðvagigtar	f j 9 l v 9 D v a c I x t a r
fjörugrjótið	f j 9: r Y k r j ou t I D
fjörugt	f j 9: r Y x t
fjörutíu	f j 9: r Y t_h i j Y
flagg	f l a k
flagið	f l ai j I D
flaki	f l a: c I
flakkaði	f l a h k a D I
flakki	f l a h c I
flass	f l a s
flassmyndir	f l a s m I n t I r
flatan	f l a: t a n
flatargjalds	f l a: t a c a l s
flatarmáli	f l a: t a r m au l I
flateyjardal	f l a: t ei j a r t a l
flatt	f l a h t
flaumi	f l 9i: m I
fleginn	f l ei: j I n
fleiri	f l ei: r I
fleirtölu	f l ei r_0 t_h 9 l Y
flekka	f l E h k a
flekkjum	f l E h c Y m
flengdi	f l ei N t I
flengja	f l ei J c a
flestallt	f l E s t a l_0 t
fletir	f l E: t I r
fletti	f l E h t I
fletting	f l E h t i N k
flinkur	f l i N_0 k Y r
fljótið	f l j ou: t I D
fljótvirkur	f l j ou: t v I r_0 k Y r
flokkar	f l O h k a r
flokkaðar	f l O h k a D a r
flokknum	f l O h k n Y m
flokks	f l O h k s
flokksins	f l O h k s I n s
flokksmenn	f l O h k s m E n
flokksþinginu	f l O h k s T i J c I n Y
flokkunar	f l O h k Y n a r
flokkunarkerfinu	f l O h k Y n a r_0 c_h E r v I n Y
flokkunarkerfisins	f l O h k Y n a r_0 c_h E r v I s I n s
flotann	f l O: t a n
flottara	f l O h t a r a
flotvörpuskipin	f l O: t v 9 r_0 p Y s c I p I n
flugakbraut	f l Y: G a k p r 9i t
flugatviki	f l Y: G a t v I c I
flugferð	f l Y x f E r D
flugfélaga	f l Y x f j E l a G a
flugfélagi	f l Y x f j E l ai j I
flugfélaginu	f l Y x f j E l ai j I n Y
flugfélagið	f l Y x f j E l ai j I D
flugfélagsins	f l Y x f j E l a x s I n s
flugherinn	f l Y G h E r I n
flugi	f l Yi j I
fluginu	f l Yi j I n Y
flugið	f l Yi j I D
flugleiða	f l Y G l ei D a
flugmenn	f l Y G m E n
flugrekendum	f l Y G r E k E n t Y m
flugrekstur	f l Y G r E k s t Y r
flugslys	f l Y x s t l I s
flugslysa	f l Y x s t l I s a
flugslysahóps	f l Y x s t l I s a h ou p s
flugslysið	f l Y x s t l I s I D
flugstarfsemi	f l Y x s t a r f s E m I
flugstöðvarinnar	f l Y x s t 9 D v a r I n a r
flugtaki	f l Y x t_h a c I
flugufréttir	f l Y: G Y f r j E h t I r
flugumferðarstjóra	f l Y: G Y m f E r D a r_0 s t j ou r a
flugupplýsingabréfum	f l Y: G Y h p l i s i N k a p r j E v Y m
fluguð	f l Y: G Y D
flugvallar	f l Y G v a t l a r
flugvallarins	f l Y G v a t l a r I n s
flugvallarskattar	f l Y G v a t l a r s k a h t a r
flugvallarsvæðinu	f l Y G v a t l a r_0 s v ai D I n Y
flugvirkja	f l Y G v I r_0 c a
flutninga	f l Y h t n i N k a
flutningabíl	f l Y h t n i N k a p i l
flutningar	f l Y h t n i N k a r
flutningnum	f l Y h t n i N k n Y m
flutnings	f l Y h t n I N s
flutningskössum	f l Y h t n i N s k_h 9 s Y m
flutningsmaður	f l Y h t n i N s m a D Y r
flutningsstarfsemi	f l Y h t n i N s t a r f s E m I
flutningsstyrk	f l Y h t n I N s t I r_0 k
flutningsstyrkja	f l Y h t n I N s t I r_0 c a
flutningur	f l Y h t n i N k Y r
flutti	f l Y h t I
fluttu	f l Y h t Y
fluttumst	f l Y h t Y m s t
flykki	f l I h c I
flykktist	f l I x t I s t
flykktust	f l I x t Y s t
flysja	f l I: s j a
flytjenda	f l I: t j E n t a
flytjist	f l I: t j I s t
fléttað	f l j E h t a D
flísar	f l i: s a r
flóabandalagið	f l ou: a p a n t a l ai j I D
flóaða	f l ou: a D a
flókinna	f l ou: c I n a
flóknar	f l ou h k n a r
flóknasta	f l ou h k n a s t a
flóttaleg	f l ou h t a l E G
flóttamannabúðum	f l ou h t a m a n a p u D Y m
flóttamenn	f l ou h t a m E n
flóttamönnum	f l ou h t a m 9 n Y m
flóttann	f l ou h t a n
flóðgáttir	f l ou D k au h t I r
flóði	f l ou: D I
flögrandi	f l 9 G r a n t I
flögruðu	f l 9 G r Y D Y
flöskunni	f l 9 s k Y n I
flötinn	f l 9: t I n
flúormengun	f l u: O r m ei N k Y n
flúorskol	f l u: O r_0 s k O l
flúrlömpum	f l u O r l 9 m_0 p Y m
fokkervél	f O h k E r v j E l
fokking	f O h c i N k
fordrykki	f O r t r I h c I
foreldrakaffi	f O: r E l t r a k_h a f I
foreldrastarfsins	f O: r E l t r a s t a r f s I n s
foreldris	f O: r E l t r I s
foringja	f O: r i J c a
foringjavagninn	f O: r i J c a v a k n I n
forkaupsréttar	f O r_0 k_h 9i p s r j E h t a r
forlaginu	f O r l ai j I n Y
forlög	f O r l 9 G
formann	f O r m a n
formælti	f O r m ai l_0 t I
fornafni	f O r n a p n I
fornafnsins	f O r n a p n_0 s I n s
fornkveðna	f O r t n k_h v E D n a
fornleifaverndar	f O r t n l ei v a v E r n t a r
forrita	f O r I t a
forritið	f O r I t I D
forritum	f O r I t Y m
forráðamenn	f O r au D a m E n
forráðamönnum	f O r au D a m 9 n Y m
forréttinda	f O r j E h t I n t a
forsetaefni	f O r_0 s E t a E p n I
forsjárlausra	f O r_0 s j au r l 9i s r a
forskoti	f O r_0 s k O t I
forskrift	f O r_0 s k r I f t
forsprakki	f O r_0 s p r a h c I
forstjórann	f O r_0 s t j ou r a n
forstjóri	f O r_0 s t j ou r I
forstofa	f O r_0 s t O v a
forstöðukonan	f O r_0 s t 9 D Y k_h O n a n
forstöðumann	f O r_0 s t 9 D Y m a n
forstöðumanninn	f O r_0 s t 9 D Y m a n I n
forsætisráðherranum	f O r_0 s ai t I s r au T h E r a n Y m
forsætisráðuneytið	f O r_0 s ai t I s r au D Y n ei t I D
forsölu	f O r_0 s 9 l Y
forvarnarstarf	f O r v a r t n a r_0 s t a r v
forvitnast	f O r v I h t n a s t
forvitnilega	f O r v I h t n I l E G a
forvitnum	f O r v I h t n Y m
forvörslu	f O r v 9 r_0 s t l Y
fossaleyni	f O s a l ei n I
fossaði	f O s a D I
fossinn	f O s I n
fossland	f O s t l a n t
fossvogi	f O s v Oi j I
fossvoginum	f O s v Oi j I n Y m
fragtskipið	f r a x t s c I p I D
frakki	f r a h c I
framfylgja	f r a m f I l c a
framfylgni	f r a m f I l n I
framfylgt	f r a m f I l_0 t
framfæri	f r a m f ai r I
framfærslu	f r a m f ai r_0 s t l Y
framfærslukostnaður	f r a m f ai r_0 s t l Y k_h O s t n a D Y r
framgangi	f r a m k au J c I
framhaldsnám	f r a m h a l t s t n au m
framhaldsnámi	f r a m h a l t s t n au m I
framhaldsnáms	f r a m h a l t s t n au m s
framhaldsskóla	f r a m h a l t s k ou l a
framhaldsskólakennara	f r a m h a l t s k ou l a c_h E n a r a
framhaldsskólakennarar	f r a m h a l t s k ou l a c_h E n a r a r
framhaldsskólakennarinn	f r a m h a l t s k ou l a c_h E n a r I n
framhaldsskólar	f r a m h a l t s k ou l a r
framhaldsskólunum	f r a m h a l t s k ou l O n Y m
framhaldsstyrk	f r a m h a l t s t I r_0 k
framhaldsverkefnum	f r a m h a l t s v E r_0 c E p n Y m
framherjann	f r a m h E r j a n
framkalla	f r a m k_h a t l a
framkallar	f r a m k_h a t l a r
framkoma	f r a m k_h O m a
framkomin	f r a m k_h O m I n
framkomu	f r a m k_h O m Y
framkvæma	f r a m k_h v ai m a
framkvæmd	f r a m k_h v ai m t
framkvæmdaaðila	f r a m k_h v ai m t a D I l a
framkvæmdamenn	f r a m k_h v ai m t a m E n
framkvæmdanefnd	f r a m k_h v ai m t a n E m t
framkvæmdanefndar	f r a m k_h v ai m t a n E m t a r
framkvæmdar	f r a m k_h v ai m t a r
framkvæmdaraðila	f r a m k_h v ai m t a r a D I l a
framkvæmdaraðili	f r a m k_h v ai m t a r a D I l I
framkvæmdarliða	f r a m k_h v ai m t a r l I D a
framkvæmdarstjórnar	f r a m k_h v ai m t a r_0 s t j ou r t n a r
framkvæmdastjóranum	f r a m k_h v ai m t a s t j ou r a n Y m
framkvæmdastjórar	f r a m k_h v ai m t a s t j ou r a r
framkvæmdastjóri	f r a m k_h v ai m t a s t j ou r I
framkvæmdastjórnarinnar	f r a m k_h v ai m t a s t j ou r t n a r I n a r
framkvæmdasýslu	f r a m k_h v ai m t a s i s t l Y
framkvæmdatíma	f r a m k_h v ai m t a t_h i m a
framkvæmdaáætlun	f r a m k_h v ai m t a au ai h t l Y n
framkvæmdinni	f r a m k_h v ai m t I n I
framkvæmdum	f r a m k_h v ai m t Y m
framköllun	f r a m k_h 9 t l Y n
framleiddu	f r a m l ei t Y
framleitt	f r a m l ei h t
framleiðnisjóður	f r a m l ei D n I s j ou D Y r
framleiðslustjóri	f r a m l ei D s t l Y s t j ou r I
framlengdi	f r a m l ei N t I
framlengdum	f r a m l ei N t Y m
framlengdur	f r a m l ei N t Y r
framlenging	f r a m l ei n c i N k
framlengingunni	f r a m l ei n c i N k Y n I
framlengja	f r a m l ei J c a
framlengt	f r a m l ei N_0 t
frammi	f r a m I
frammundir	f r a m Y n t I r
framselt	f r a m s E l_0 t
framskyggn	f r a m s c I k n_0
framsóknarflokkinn	f r a m s ou h k n a r_0 f l O h c I n
framsóknarflokknum	f r a m s ou h k n a r f l O h k n Y m
framsóknarflokks	f r a m s ou h k n a r f l O k s
framsóknarflokksins	f r a m s ou h k n a r f l O h k s I n s
framsóknarflokkur	f r a m s ou h k n a r f l O h k Y r
framsóknarflokkurinn	f r a m s ou h k n a r_0 f l O h k Y r I n
framsýnn	f r a m s i t n_0
framsýnni	f r a m s i t n I
framtalsskil	f r a m t_h a l s c I l
framtíðarskipan	f r a m t_h i D a r s c I p a n
framtíðarstefnu	f r a m_0 t_h i D a r_0 s t E p n Y
framtíðarveröld	f r a m t_h i D a r v E r 9 l t
framtíðarþróun	f r a m t_h i D a r T r ou Y n
framúrskarandi	f r a m u r s k a r a n t I
franka	f r a N k_h a
frankinn	f r a J_0 c I n
fress	f r E s
freysteinn	f r ei: s t ei t n
friðarsamkomulagi	f r I: D a r_0 s a m k_h O m Y l ai j I
friðbjörnsson	f r I D p j 9 r_0 s O n
friðsæll	f r I D s ai t l_0
friðþjófi	f r I T j ou v I
frjálshyggjumannsins	f r j au l s h I c Y m a n s I n s
frjálshyggjutaug	f r j au l s h I c Y t_h 9i G
frostkaldan	f r O s t k_h a l t a n
frumflutning	f r Y m f l Y h t n I N k
frumflutningur	f r Y m f l Y h t n I N k Y r
frumflytja	f r Y m f l I t j a
frumkvæði	f r Y m k_h v ai D I
frumkvæðisaðilar	f r Y m k_h v ai D I s a D I l a r
frumkvöðlafræðsla	f r Y m k_h v 9 D l a f r ai D s t l a
frumkvöðlar	f r Y m_0 k_h v 9 D l a r
frumkvöðlum	f r Y m k_h v 9 D l Y m
frumkvöðlunum	f r Y m k_h v 9 D l O n Y m
frumskóginn	f r Y m s k ou j I n
frumskóginum	f r Y m s k ou j I n Y m
frumvarp	f r Y m v a r_0 p
frumvarpi	f r Y m v a r_0 p I
frumvarps	f r Y m v a r_0 p s
frumvarpsins	f r Y m v a r_0 p s I n s
frumættleiða	f r Y: m ai h t l ei D a
frygð	f r I G D
fráfarandi	f r au: f a r a n t I
frágangi	f r au: k au J c I
frágangur	f r au: k au N k Y r
fráhvarfseinkenni	f r au: k_h v a r f s ei J c_h E n I
fræddi	f r ai t I
frændfólki	f r ai n t f ou l_0 c I
frændsystkini	f r ai n t s I s c I n I
frændsystkinin	f r ai n t s I s t c_h I n I n
frænkunum	f r ai N_0 k O n Y m
fræðilegum	f r ai: D I l E G Y m
fræðslumiðstöðvar	f r ai D s t l Y m I D s t 9 D v a r
fréttamanninn	f r j E h t a m a n I n
fréttaritari	f r j E h t a r I t a r I
fréttastofuna	f r j E h t a s t O v Y n a
fréttatengdir	f r j E h t a t_h ei N t I r
fréttatengt	f r j E h t a t ei N_0 t
fréttnæmt	f r j E h t n ai m_0 t
fríkirkjuvegi	f r i c_h I r_0 c Y v ei j I
frískt	f r i s t
fríverslun	f r i: v E r_0 s t l Y n
fríverslunarsamningur	f r i: v E r_0 s t l Y n a r s a m n i N k Y r
frómt	f r ou m_0 t
frúnni	f r u n I
fuglastúlka	f Y k l a s t u l_0 k a
fuglunum	f Y k l O n Y m
fullklædd	f Y t l k_h l ai t
fullkomið	f Y t l k_h O m I D
fullkomnu	f Y t l_0 k_h O m n Y
fullkomnustu	f Y t l k_h O m n Y s t Y
fullorðinna	f Y t l O r D I n a
fullorðinsár	f Y t l O r D I n s au r
fullorðnar	f Y t l O r t n a r
fullorðnum	f Y t l O r t n Y m
fulls	f Y l s
fullskipuð	f Y t l_0 s c I p Y D
fullstór	f Y t l_0 s t ou r
fullt	f Y l_0 t
fulltingis	f Y t l_0 t_h i J c I s
fulltrúaaðild	f Y t l_0 t_h r u a D I l t
fulltrúaráð	f Y t l_0 t_h r u a r au D
fulltrúaráðs	f Y l_0 t_h r u a r au D s
fullvissir	f Y t l v I s I r
fullyrt	f Y t l I r_0 t
fullyrði	f Y t l I r D I
fullyrðingarsetningin	f Y t l I r D i N k a r_0 s E h t n i J c I n
fullþakkað	f Y t l T a h k a D
fursta	f Y r_0 s t a
furstanum	f Y r_0 s t a n Y m
fursti	f Y r_0 s t I
furstinn	f Y r_0 s t I n
furutré	f Y: r Y t_h r j E
furðuðu	f Y r D Y D Y
fylgdarliði	f I l t a r l I D I
fylgdarmaður	f I l t a r m a D Y r
fylgdarmaðurinn	f I l t a r m a D Y r I n
fylgdi	f I l t I
fylgdust	f I l t Y s t
fylgibreytu	f I l c I p r ei t Y
fylgikvilla	f I l c I k_h v I t l a
fylgja	f I l c a
fylgjandi	f I l c a n t I
fylgjast	f I l c a s t
fylgjumst	f I l c Y m s t
fylgni	f I l n I
fylki	f I l_0 c I
fylking	f I l_0 c i N k
fylkingum	f I l_0 c i N k Y m
fylkingunni	f I l_0 c i N k Y n I
fylkir	f I l_0 c I r
fylkishöfðingi	f I l_0 c I s h 9 v D i J c I
fylkishöfðinginn	f I l_0 c I s h 9 v D i J c I n
fylkismanna	f I l_0 c I s m a n a
fylkismenn	f I l_0 c I s m E n
fyllast	f I t l a s t
fylleríi	f I t l I r i j I
fyllibyttan	f I t l I p I h t a n
fylliríi	f I t l I r i I
fylliríinu	f I t l I r i I n Y
fylliríið	f I t l I r i I D
fyllst	f I l s t
fyllstu	f I l s t Y
fylltar	f I l_0 t a r
fyllti	f I l_0 t I
fylltist	f I l_0 t I s t
fylltu	f I l_0 t Y
fylltust	f I l_0 t Y s t
fyrirbyggja	f I: r I r_0 p I c a
fyrirgangur	f I: r I r_0 k au N k Y r
fyrirgefningu	f I: r I r c E p n i N k Y
fyrirkallaður	f I: r I r_0 k_h a t l a D Y r
fyrirkomulagið	f I: r I r_0 k_h O m Y l ai j I D
fyrirlesari	f I: r I r l E s a r I
fyrirlestri	f I: r I r l E s t r I
fyrirlitið	f I: r I r l I t I D
fyrirlitning	f I: r I r l I h t n I N k
fyrirliðinn	f I: r I r l I D I n
fyrirlítur	f I: r I r l i t Y r
fyrirrennara	f I: r I r E n a r a
fyrirsjáanlegt	f I: r I r_0 s j au a n l E x t
fyrirskipanir	f I: r I r_0 s c I p a n I r
fyrirskipunum	f I: r I r s c I p Y n Y m
fyrirskrifað	f I: r I r_0 s k r I v a D
fyrirsvarinu	f I: r I r_0 s v a r I n Y
fyrirtækjakaup	f I: r I r_0 t_h ai c a k_h 9i p
fyrirtækjanna	f I: r I r_0 t_h ai c a n a
fyrra	f I r a
fyrradag	f I r a t a G
fyrrakvöld	f I r a k_h v 9 l t
fyrrgreind	f I r k r ei n t
fyrrgreindu	f I r k r ei n t Y
fyrri	f I r I
fyrrihluta	f I r I l_0 Y t a
fyrrinótt	f I r I n ou h t
fyrrnefnd	f I r n E m t
fyrrnefnda	f I r n E m t a
fyrrnefndi	f I r n E m t I
fyrrnefndri	f I r n E m t r I
fyrrum	f I r Y m
fyrsts	f I s t s
fágað	f au: G a D
fágun	f au: G Y n
fáguð	f au: G Y D
fákeppni	f au: c E h p n I
fálka	f au l_0 k a
fálkagötu	f au l_0 k a k 9 t Y
fálkann	f au l_0 k a n
fálki	f au l_0 c I
fáránlegri	f au: r au n l E G r I
fátæk	f au: t_h ai k
fátæklinga	f au: t_h ai h k l i N k a
fátæklingar	f au: t_h ai h k l i N k a r
fátækri	f au: t_h ai k r I
fátæktinni	f au: t_h ai x t I n I
fæddist	f ai t I s t
færni	f ai r t n I
færra	f ai r a
færri	f ai r I
fæðubótarefna	f ai: D Y p ou t a r E p n a
fékkstu	f j E h k s t Y
félagasamtaka	f j E: l a G a s a m t_h a k a
félagi	f j E: l ai j I
félaginu	f j E: l ai j I n Y
félagið	f j E: l ai j I D
félagsgjöld	f j E: l a x s c 9 l t
félagslegar	f j E: l a x s t l E G a r
félagslegri	f j E: l a x s t l E G r I
félagslynd	f j E: l a k s t l I n t
félagslyndur	f j E: l a x s t l I n t Y r
félagsmenn	f j E: l a x s m E n
félagsmiðstöð	f j E: l a x s m I D s t 9 D
félagsmálastofnun	f j E: l a x s m au l a s t O p n Y n
félagsmönnum	f j E: l a x s m 9 n Y m
félagsskapar	f j E: l a x s k a p a r
félagsstarfinu	f j E: l a x s t a r v I n Y
félagsþjónustu	f j E: l a x s T j ou n Y s t Y
féll	f j E t l_0
féllst	f j E l s t
féllu	f j E t l Y
fífldirfsku	f i p l t I r v s k Y
fíflinu	f i p l I n Y
fíflum	f i p l Y m
fíkniefnaneyslu	f i h k n I E p n a n ei s t l Y
fíkniefnaneytendur	f i h k n I E p n a n ei t E n t Y r
fíngerðum	f i J c E r D Y m
fínni	f i t n I
fólgnar	f ou l n a r
fólgnir	f ou l n I r
fólki	f ou l_0 c I
fólkið	f ou l_0 c I D
fólks	f ou l_0 k s
fólksbifreið	f ou l s p I v r ei D
fólksbíla	f ou l_0 k s p i l a
fólksfjölgun	f ou l_0 k s f j 9 l k Y n
fórnarlömbin	f ou r t n a r l 9 m p I n
fótanudd	f ou: t a n Y t
fótlegg	f ou t l E k
föggum	f 9 k Y m
fölleitur	f 9 l ei t Y r
föllnu	f 9 t l n Y
föngnum	f 9i N n Y m
fönguleg	f 9i N k Y l E G
föngum	f 9i N k Y m
föngunum	f 9i N k O n Y m
fönguðu	f 9i N k Y D Y
föstudaga	f 9 s t Y t a G a
föstudagskvöldið	f 9 s t Y t a x s k_h v 9 l t I D
föstudagur	f 9 s t Y t a G Y r
föðurbróður	f 9: D Y r p r ou D Y r
fúlt	f u l_0 t
gabb	k a p
gabba	k a p a
gaddakylfu	k a t a c_h I l v Y
gaffal	k a f a l
gaffalinn	k a f a l I n
gaffals	k a f a l s
gaffli	k a f l I
gafflinum	k a f l I n Y m
gafla	k a p l a
gaggaði	k a k a D I
gagnabanka	k a k n a p au N_0 k a
gagnagrunn	k a k n a k r Y n
gagnagrunninn	k a k n a k r Y n I n
gagnagrunnum	k a k n a k r Y n Y m
gagnagrunnur	k a k n a k r Y n Y r
gagnasafnskerfis	k a k n a s a p n_0 s c_h E r v I s
gagnaskráningarkerfi	k a k n a s k r au n i N k a r_0 c E r v I
gagnasöfnum	k a k n a s 9 p n Y m
gagngerar	k a c E r a r
gagngert	k a c E r_0 t
gagnist	k a k n I s t
gagnkvæm	k a k_h v ai m
gagnkvæmum	k a k_h v ai m Y m
gagnlegt	k a k l E x t
gagnrýnni	k a k r i t n I
gagns	k a k n_0 s
gagnsemi	k a k n_0 s E m I
gagnslaust	k a k n_0 s t l 9i s t
gagnstætt	k a k s t ai h t
gagnstæða	k a k n_0 s t ai D a
gagnsæ	k a k n_0 s ai
gagntaka	k a k n_0 t_h a k a
gagnvirkt	k a k v I r_0 t
gakk	k a h k
gakktu	k a x t Y
galakvöld	k a: l a k_h v 9 l t
galdrahyskinu	k a l t r a h I s c I n Y
galdurinn	k a l t Y r I n
galið	k a: l I D
gall	k a t l_0
galla	k a l a
gallabuxum	k a l a p Y k s Y m
gallabuxur	k a l a p Y k s Y r
gallajökkum	k a l a j 9 h k Y m
gallann	k a t l a n
gallharður	k a t l_0 h a r D Y r
gallsteinabriskirtilsbólgu	k a t l_0 s t ei n a p r I s c_h I r_0 t I l s p ou l k Y
gallstíflunni	k a t l s t i p l Y n I
galopnum	k a: l O h p n Y m
gamalkunna	k a: m a l k_h Y n a
gamalli	k a: m a t l I
gamals	k a: m a l s
gamalt	k a: m a l_0 t
gamanmyndaflokkur	k a: m a n m I n t a f l O h k Y r
gamans	k a: m a n s
gamlárskvöld	k a m l au r_0 s k_h v 9 l t
gamminn	k a m I n
ganganna	k au N k a n a
gangar	k au N k a r
gangbrautarvarsla	k au N k p r 9i t a r v a r_0 s t l a
gangfær	k au N k f ai r
ganginn	k au J c I n
gangs	k au N s
gangsett	k au N s E h t
gangstéttum	k au N s t j E h t Y m
gangstéttunum	k au N k s t j E h t O n Y m
gangur	k au N k Y r
gapandi	k a: p a n t I
gargi	k a r c I
garp	k a r_0 p
garðahringsins	k a r D a r_0 i N s I n s
garðarssonar	k a r D a r_0 s O n a r
gasjöfnunina	k a: s j 9 p n Y n I n a
gatnamótin	k a h t n a m ou t I n
gatnamótum	k a h t n a m ou t Y m
gauknum	k 9i h k n Y m
gaupnir	k 9i h p n I r
gaur	k 9i: r
gefin	c E: v I n
gefnar	c E p n a r
gefnum	c E p n Y m
gefst	c E f s t
geggjaður	c E c a D Y r
gegn	c E k n_0
gegna	c E k n a
gegndrepa	c E k t r E p a
gegnsær	c E k n_0 s ai r
gegnsósa	c E k n_0 s ou s a
gegnt	c ei N_0 t
gegnumgangandi	c E k n Y m k au N k a n t I
geilinni	c ei: l I n I
geimflaugar	c ei: m f l 9i G a r
geirfinn	c ei r f I n
geirsson	c ei r_0 s O n
geirssonar	c ei r_0 s O n a r
geirvörtuna	c ei r v 9 r_0 t Y n a
geirvörtur	c ei r v 9 r_0 t Y r
geisladisk	c ei s t l a t I s k
geisladiskum	c ei s t l a t I s k Y m
geisladrifið	c ei s t l a t r I v I D
geislameðferð	c ei s t l a m E D f E r D
geislanum	c ei s t l a n Y m
geislar	c ei s t l a r
geislavirks	c ei s t l a v I r_0 k s
geislum	c ei s t l Y m
geispaði	c ei s p a D I
geitungaofsóknum	c ei: t u N k a O f s ou h k n Y m
gelda	c E l t a
gellur	c E l l Y r
gelt	c E l_0 t
gelta	c E l_0 t a
gemsann	c E m s a n
gemsinn	c E m s I n
gengdarlausa	c ei N t a r l 9i s a
gengin	c ei J c I n
gengishagnaður	c ei J c I s h a k n a D Y r
gengiskráningarvog	c ei J c I s k r au n i N k a r v O x
gengislækkun	c ei J c I s t l ai h k Y n
gengislækkunar	c ei J c I s t l ai h k Y n a r
gengist	c ei J c I s t
gengisþróun	c ei J c I s T r ou Y n
gengisþróunar	c ei J c I s T r ou Y n a r
gengið	c ei J c I D
gengju	c ei J c Y
gengjur	c ei J c Y r
gengnum	c ei N n Y m
gengst	c ei N s t
gengt	c ei N_0 t
gengu	c ei N k Y
gengurðu	c ei N k Y r D Y
georgs	c E: O r k s
georgsson	c E: O r k s O n
gerandinn	c E: r a n t I n
gerbreytt	c E r p r ei h t
gerdeig	c E r t ei G
gereyðilagt	c E: r ei D I l a x t
geri	c E: r I
gerir	c E: r I r
gerist	c E: r I s t
gerlegt	c E r t l E x t
gerplu	c E r_0 p l Y
gervalla	c E r v a t l a
gervitungl	c E r v I t u N l
gerðarsafn	c E r D a r_0 s a p n_0
gerðarsafni	c E r D a r_0 s a p n I
gerðubergs	c E r D Y p E r k s
gestafyrirlestur	c E s t a f I r I r l E s t Y r
gestaherbergi	c E s t a h E r p E r c I
gestgjafann	c E s t c a v a n
gestkomandi	c E s k O m a n t I
gests	c E s t s
gestsdóttir	c E s t s t ou h t I r
gestsdóttur	c E s t s t ou h t Y r
gestsins	c E s t s I n s
gestunum	c E s t O n Y m
getnaðarlim	c E h t n a D a r l I m
geymdar	c ei m t a r
geymir	c ei: m I r
geymsla	c ei m s t l a
geysistór	c ei: s I s t ou r
geðheilsu	c E D h ei l s Y
geðhjálpar	c E D C au l_0 p a r
geðið	c E: D I D
geðklofa	c E D k_h l O v a
geðklofasjúklings	c E D k_h l O v a s j u h k l i N s
geðlækni	c E D l ai h k n I
geðlæknis	c E D l ai h k n I s
geðs	c E D s
geðveiki	c E D v ei c I
geðþótta	c E T ou h t a
gifs	c I f s
gift	c I f t
giftast	c I f t a s t
gifti	c I f t I
giftingar	c I f t i N k a r
gigtarsjúkdómum	c I x t a r_0 s j u k t ou m Y m
gigtarsjúklingum	c I x t a r_0 s j u h k l i N k Y m
gigtsjúkdóma	c I x t s j u k t ou m a
gikkinn	c I h c I n
gilbert	c I l p E r_0 t
gilitrutt	c I: l I t_h r Y h t
gilti	c I l_0 t I
gimsteinn	c I m s t ei t n_0
ginnungagap	c I n u N k a k a p
girðingunni	c I r D i N k Y n I
gissurardóttur	c I s Y r a r t ou h t Y r
gistinefndin	c I s t I n E m t I n
gististað	c I s t I s t a D
gjafirnar	c a: v I r t n a r
gjaldahlið	c a l t a l_0 I D
gjaldheimtur	c a l t h ei m_0 t Y r
gjaldi	c a l t I
gjaldkera	c a l t c_h E r a
gjaldmiðill	c a l t m I D I t l_0
gjaldmiðli	c a l t m I D l I
gjaldskrá	c a l t s k r au
gjammandi	c a m a n t I
gjábakki	c au: p a h c I
gjöfin	c 9: v I n
gjöful	c 9: v Y l
gjöfunum	c 9: v O n Y m
gjörgæsludeilda	c 9 r c ai s t l Y t ei l t a
gjörningsbréfi	c 9 r t n i N s p r j E v I
gjörónýtt	c 9: r ou n i h t
glampa	k l a m_0 p a
glampandi	k l a m_0 p a n t I
glampanum	k l a m_0 p a n Y m
glampar	k l a m_0 p a r
glampi	k l a m_0 p I
glampinn	k l a m_0 p I n
glansaði	k l a n s a D I
glanspappír	k l a n s p_h a h p i r
glapræði	k l a: p r ai D I
glasinu	k l a: s I n Y
glataðist	k l a: t a D I s t
glaðari	k l a: D a r I
glaðlegri	k l a D l E G r I
glaðsinna	k l a D s I n a
glenna	k l E n a
glerskurður	k l E r_0 s k Y r D Y r
glerveggjum	k l E r v E c Y m
glerárkirkja	k l E: r au r c_h I r_0 c a
glettni	k l E h t n I
gleypa	k l ei: p a
gleypt	k l ei f t
gleðilegra	k l E: D I l E G r a
gleðisveitanna	k l E: D I s v ei t a n a
glit	k l I: t
glitrandi	k l I: t r a n t I
gljámistill	k l j au: m I s t I t l_0
gljáðu	k l j au: D Y
glottandi	k l O h t a n t I
gluggakistu	k l Y k a c_h I s t Y
gluggakistuna	k l Y k a c_h I s t Y n a
gluggalaus	k l Y k a l 9i s
gluggalausri	k l Y k a l 9i s r I
gluggann	k l Y k a n
glugganum	k l Y k a n Y m
gluggasláttur	k l Y k a s t l au h t Y r
gluggatjaldanna	k l Y k a t_h j a l t a n a
gluggatjöldin	k l Y k a t_h j 9 l t I n
gluggatjöldum	k l Y k a t_h j 9 l t Y m
gluggatjöldunum	k l Y k a t_h j 9 l t Y n Y m
glugginn	k l Y c I n
glápir	k l au: p I r
glæpsamlegt	k l ai p s a m l E x t
glæsilegir	k l ai: s I l ei j I r
glæsilegt	k l ai: s I l E x t
glögg	k l 9 k
glögglega	k l 9 k l E G a
glöggskyggn	k l 9 k s c I k n_0
glöggva	k l 9 k v a
glömpuðu	k l 9 m_0 p Y D Y
gogginum	k O c I n Y m
goggur	k O k Y r
goggurinn	k O k Y r I n
golfklúbbi	k O l f k_h l u p I
golfklúbbur	k O l f k_h l u p Y r
golfspilakassi	k O l v s p I l a k_h a s I
golfvöllinn	k O l v 9 t l I n
gormælt	k O r m ai l_0 t
gorta	k O r_0 t a
gosbrunnur	k O s p r Y n Y r
gosdrykk	k O s t r I h k
gottskálksson	k O h t s k au l_0 k s O n
gottskálkssyni	k O h t s k au l_0 k s I n I
grafalvarlegur	k r a: v a l v a r l E G Y r
grafarholts	k r a: v a r h O l_0 t s
grafarvog	k r a: v a r v O G
grafarvogi	k r a: v a r v Oi j I
grafarvogs	k r a: v a r v O x s
grafarþögn	k r a: v a r T 9 k n_0
grafast	k r a: v a s t
grafkyrr	k r a f c_h I r
grafkyrrir	k r a f c_h I r I r
grafskrift	k r a f s k r I f t
grafíkmöppum	k r a: f i k m 9 h p Y m
gramm	k r a m
grammófón	k r a m ou f ou n
granatepli	k r a: n a t E h p l I
grandavegi	k r a n t a v ei j I
grandskoðaði	k r a n t s k O D a D I
graskersættinni	k r a s c E r_0 s ai h t I n I
grautnum	k r 9i h t n Y m
greiddan	k r ei t a n
greifinn	k r ei: v I n
greikkaði	k r ei h k a D I
greindarlegt	k r ei n t a r l E x t
greiningardeild	k r ei: n i N k a r t ei l t
greiðslumatsskýrslu	k r ei D s t l Y m a t s c i r_0 s t l Y
greiðsluseðill	k r ei D s t l Y s E D I t l_0
greiðvikinn	k r ei D v I c I n
grenjaðarstað	k r E n j a D a r_0 s t a D
grensásveg	k r E n s au s v E G
grensásvegi	k r E n s au s v ei j I
greypt	k r ei f t
gribba	k r I p a
grikki	k r I h c I
grikkir	k r I h c I r
grikkja	k r I h c a
grikkjanna	k r I h c a n a
grikklandi	k r I h k l a n t I
grill	k r I l
grillaðar	k r I l a D a r
grillostur	k r I l O s t Y r
grillur	k r I t l Y r
grimma	k r I m a
grimmu	k r I m Y
grimmum	k r I m Y m
gripakofinn	k r I: p a k_h O v I n
gripnir	k r I h p n I r
gripur	k r I: p Y r
grisju	k r I: s j Y
grjóthnullungum	k r j ou t n_0 Y t l u N k Y m
gruggugt	k r Y k Y x t
grundvallareining	k r Y n t v a t l a r ei n i N k
grundvallarreglur	k r Y n t v a t l a r E k l Y r
grundvallarsamþykkt	k r Y n t v a t l a r_0 s a m T I x t
grunngildi	k r Y J c I l t I
grunnhreinsun	k r Y n r_0 ei n s Y n
grunnrannsóknir	k r Y n r a n s ou h k n I r
grunnskólaaldri	k r Y n s k ou l a a l t r I
grunnt	k r Y n_0 t
grunnverð	k r Y n v E r D
grunsamlegt	k r Y n s a m l E x t
gráleitt	k r au: l ei h t
grásvepp	k r au: s v E h p
græddu	k r ai t Y
grængylltan	k r ai n c I l_0 t a n
grænlands	k r ai n l a n t s
grænn	k r ai t n_0
grétarssyni	k r j E: t a r_0 s I n I
grímsnesi	k r i m s t n E s I
gríngáfu	k r i n k au v Y
grínkaflinn	k r i: n k_h a p l I n
gríðarleg	k r i: D a r l E G
grófarhús	k r ou: v a r h u s
gróffóðursins	k r ou f ou D Y r_0 s I n s
gróft	k r ou f t
grófur	k r ou: v Y r
gróðurinn	k r ou: D Y r I n
gróðursetning	k r ou: D Y r s E h t n I N k
gugga	k Y k a
gulleitt	k Y l ei h t
gullfoss	k Y t l_0 f O s
gullhring	k Y t l r_0 i N k
gullinn	k Y t l I n
gulllóa	k Y t l l ou a
gullnu	k Y t l n Y
gulls	k Y l s
gullsmárabrids	k Y t l_0 s m au r a p r I t s
gullstrandarinnar	k Y t l s t r a n t a r I n a r
gullu	k Y l Y
gullverðlaun	k Y t l_0 v E r D l 9i n
gullverðlauna	k Y t l v E r l 9i n a
gullæðanna	k Y t l ai D a n a
gullæðið	k Y t l ai D I D
gumma	k Y m a
gunnars	k Y n a r_0 s
gunnarsdóttur	k Y n a r_0 s t ou h t Y r
gunnlaugi	k Y n l 9i j I
gunnlaugssonar	k Y n l 9i x s O n a r
gunnlaugur	k Y n l 9i G Y r
gunnsteinn	k Y n s t ei t n_0
gutlaði	k Y h t l a D I
guðbergsson	k v Y D p E r k s O n
guðbjartsson	k v Y D p j a r_0 t s O n
guðbjörnsdóttir	k v Y D p j 9 r s t ou h t I r
guðbjörnsson	k v Y D p j 9 r_0 s O n
guðbrandsdóttir	k v Y D p r a n t s t ou h t I r
guðbrandsson	k v Y D p r a n t s O n
guðhrædda	k v Y D r_0 ai t a
guðleysingjar	k v Y D l ei s i J c a r
guðmarsson	k v Y D m a r_0 s O n
guðmundsdóttir	k v Y D m Y n t s t ou h t I r
guðspjöllin	k v Y D s p j 9 t l I n
gyllt	c I l_0 t
gylltri	c I l_0 t r I
gylltum	c I l_0 t Y m
gyðinga	c I: D i N k a
gyðingasamtakanna	c I: D i N k a s a m t_h a k a n a
gáfaður	k au: v a D Y r
gáfnafari	k au p n a f a r I
gáfum	k au: v Y m
gáfurnar	k au: v Y r t n a r
gára	k au: r a
gátum	k au: t Y m
gæddi	c ai t I
gæfumaður	c ai: v Y m a D Y r
gægðist	c ai G D I s t
gægðust	c ai G D Y s t
gæslumaðurinn	c ai s t l Y m a D Y r I n
gæðaflokki	c ai: D a f l O h c I
gígja	c i j a
gígju	c i j Y
gírstönginni	c i r_0 s t 9i J c I n I
gísladóttir	c i s t l a t ou h t I r
gíslason	c i s t l a s O n
gólf	k ou l f
gólffjalirnar	k ou l f j a l I r t n a r
gólffjölunum	k ou l f j 9 l Y n Y m
góndum	k ou n t Y m
góðgerðarstarfsemi	k ou D c E r D a r_0 s t a r f s E m I
góðir	k ou: D I r
góðviðrisdögum	k ou D v I D r I s t 9 G Y m
göfuga	k 9: v Y G a
gönguferðir	k 9i N k Y f E r D I r
göngugötuna	k 9i N k Y k 9 t Y n a
göngulagi	k 9i N k Y l ai j I
göngulaginu	k 9i N k Y l ai j I n Y
göngulagið	k 9i N k Y l ai j I D
göngunum	k 9i N k O n Y m
göngustíg	k 9i N k Y s t i G
gúlpaði	k u l_0 p a D I
gúmmíbátinn	k u m i p au t I n
gúmmíhandföngin	k u m i h a n t f 9i J c I n
gúmmíhanska	k u m i h a n s k a
gúmmíi	k u m i I
gúmmískór	k u m i s k ou r
gúmmístígvélum	k u m i s t i G v j E l Y m
gúmmístígvélunum	k u m i s t i G v j E l O n Y m
gúmmítrjáa	k u m i t_h r j au a
gúmmítrjánna	k u m i t_h r j au n a
gúmmítré	k u m i t_h r j E
haffa	h a f a
haffærisskírteini	h a f ai r I s c i r_0 t ei n I
hafinn	h a: v I n
hafir	h a: v I r
hafna	h a p n a
hafnar	h a p n a r
hafnarboltaknattleik	h a p n a r p O l_0 t a k_h n a h t l ei k
hafnarfjarðarbæ	h a p n a r f j a r D a r p ai
hafnarframkvæmdum	h a p n a r f r a m k_h v ai m t Y m
hafnarhús	h a p n a r h u s
hafnarhúsið	h a p n a r_0 h u s I D
hafnarkjaftur	h a p n a r_0 c_h a f t Y r
hafsteinsdóttir	h a f s t ei n s t ou h t I r
hafta	h a f t a
hafurtask	h a: v Y r t_h a s k
hafður	h a v D Y r
hagbjörtu	h a G p j 9 r_0 t Y
haggast	h a k a s t
hagkvæmri	h a G k_h v ai m r I
haglabyssu	h a k l a p I s Y
hagnaðarskyni	h a k n a D a r_0 s c I n I
hagnýtri	h a G n i t r I
hagrætt	h a G r ai h t
hagræðingu	h a G r ai D i N k Y
hagsmunasamtökum	h a x s m Y n a s a m t_h 9 k Y m
hagvaxtarskeið	h a G v a k s t a r_0 s c ei D
haldlagt	h a l t l a x t
halla	h a t l a
hallarbúning	h a t l a r p u n i N k
hallardrykkur	h a t l a r t r I h k Y r
hallað	h a t l a D
halldóri	h a l t ou r I
halldórsdóttir	h a l t ou r_0 s t ou h t I r
hallfríður	h a t l_0 f r i D Y r
hallgrímskirkjuturn	h a t l_0 k r i m s c_h I r_0 c Y t_h Y r t n_0
halls	h a l s
hallur	h a t l Y r
hamarháfi	h a: m a r h au v I
hamars	h a: m a r_0 s
hamingjan	h a: m i J c a n
hamingju	h a: m i J c Y
hamingjuna	h a: m i J c Y n a
hamingjusaman	h a: m i J c Y s a m a n
hamingjusamir	h a: m i J c Y s a m I r
hamingjusöm	h a: m i J c Y s 9 m
hampa	h a m_0 p a
hampaði	h a m_0 p a D I
hamskiptum	h a m s c I f t Y m
hamslausri	h a m s t l 9i s r I
handagangur	h a n t a k au N k Y r
handahófi	h a n t a h ou v I
handboltakvöld	h a n t p O l_0 t a k_h v 9 l t
handbragð	h a n t p r a G D
handbragði	h a n t p r a G D I
handfanginu	h a n t f au J c I n Y
handfestu	h a n t f E s t Y
handjárnin	h a n t j au r t n I n
handknattleikur	h a n t k_h n a h t l ei k Y r
handlaginn	h a n t l ai j I n
handleggir	h a n t l E c I r
handleggjunum	h a n t l E c O n Y m
handritshöfundar	h a n t r I t s h 9 v Y n t a r
handrukkarinn	h a n t r Y h k a r I n
handsprengjur	h a n t s p r ei J c Y r
handstýrt	h a n t s t i r_0 t
handteknir	h a n t_h E h k n I r
handtökin	h a n t_h 9 c I n
handuggum	h a n t Y k Y m
handverks	h a n t v E r_0 k s
handverksmunum	h a n t v E r_0 k s m Y n Y m
handvirkt	h a n t v I r_0 t
hangikjötsilm	h au J c I c_h 9 t s I l m
hangir	h au J c I r
hangs	h au N s
hangsa	h au N s a
hannaðar	h a n a D a r
hannessyni	h a n E s I n I
happ	h a h p
happdrættis	h a h p t r ai h t I s
haraldsdóttur	h a: r a l t s t ou h t Y r
haraldsson	h a: r a l t s O n
haraldssonar	h a: r a l t s O n a r
harmkvælum	h a r m k_h v ai l Y m
harmleikur	h a r m l ei k Y r
harðastökki	h a r D a s t 9 h c I
harðfiskhjallur	h a r D f I s k C a t l Y r
harðlæst	h a r D l ai s t
harðnandi	h a r t n a n t I
harðneskjulegt	h a r D n E s c Y l E x t
harðákveðin	h a r D au k_h v E D I n
hassi	h a s I
haughúss	h 9i G h u s
haustdögum	h 9i s t 9 G Y m
haustmyrkurs	h 9i s t m I r_0 k Y r_0 s
hausts	h 9i s t s
hefnast	h E p n a s t
hefnd	h E m t
hefnda	h E m t a
hefndar	h E m t a r
hefndum	h E m t Y m
heftin	h E f t I n
hefðbundinn	h E v p Y n t I n
hegg	h E k
heggur	h E k Y r
hegningarlögum	h E k n i N k a r l 9 G Y m
hegranesþing	h E G r a n E s T i N k
hegða	h E G D a
hegðunar	h E G D Y n a r
hegðuðu	h E G D Y D Y
heilablóðfallsskaðaðra	h ei: l a p l ou D f a t l s k a D a D r a
heilahrörnun	h ei: l a r_0 9 r t n Y n
heilbrigt	h ei: l p r I x t
heilbrigða	h ei l p r I G D a
heilbrigðis	h ei l p r I G D I s
heilbrigðisfulltrúa	h ei l p r I G D I s f Y l_0 t_h r u a
heilbrigðishugtökum	h ei l p r I G D I s h Y G t_h 9 k Y m
heilbrigðiskerfisins	h ei l p r I G D I s c_h E r v I s I n s
heilbrigðisnefnd	h ei l p r I G D I s t n E m t
heilbrigðisráðherra	h ei l p r I G D I s r au T h E r a
heilbrigðisráðuneytisins	h ei l p r I G D I s r au D Y n ei t I s I n s
heilbrigðisráðuneytið	h ei l p r I G D I s r au D Y n ei t I D
heilbrigðisstofnunum	h ei l p r I G D I s t O p n Y n Y m
heilbrigðisstétta	h ei l p r I G D I s t j E h t a
heilbrigðissviði	h ei l p r I G D I s v I D I
heilbrigðisyfirvalda	h ei l p r I G D I s I v I r v a l t a
heilbrigðisþjónustunni	h ei l p r I G D I s T j ou n Y s t Y n I
heilbrigðu	h ei l p r I G D Y
heildarendurskoðun	h ei l t a r E n t Y r s k O D Y n
heildarpakkann	h ei l t a r_0 p_h a h k a n
heildarskipulag	h ei l t a r_0 s c I p Y l a G
heildarskuldir	h ei l t a r_0 s k Y l t I r
heildsölufyrirtækinu	h ei l t s 9 l Y f I r I r_0 t_h ai c I n Y
heilkenni	h ei l c_h E n I
heillast	h ei t l a s t
heilmargt	h ei l m a r_0 t
heilsaði	h ei l s a D I
heilsteypt	h ei l s t ei f t
heilsubrests	h ei l s Y p r E s t s
heilsufar	h ei l s Y f a r
heilsugæslulækna	h ei l s Y c ai s t l Y l ai h k n a
heilsugæslustöðvar	h ei l s Y c ai s t l Y s t 9 D v a r
heilsugæsluumdæmin	h ei l s Y c ai s t l Y Y m t ai m I n
heilsutjóni	h ei l s Y t_h j ou n I
heilsíðugrein	h ei l s i D Y k r ei n
heima	h ei: m a
heimakrókum	h ei: m a k_h r ou k Y m
heimalandsins	h ei: m a l a n t s I n s
heimanmund	h ei: m a n m Y n t
heimavistarskóla	h ei: m a v I s t a r s k ou l a
heimildarmyndir	h ei: m I l t a r m I n t I r
heimilisfang	h ei: m I l I s f au N k
heimilisfólkið	h ei: m I l I s f ou l_0 c I D
heimilislækna	h ei: m I l I s l ai h k n a
heimilislækni	h ei: m I l I s t l ai h k n I
heimill	h ei: m I t l_0
heimleið	h ei m l ei D
heimsbyggðina	h ei m s p I G D I n a
heimskingi	h ei m s c i J c I
heimskringla	h ei m s k_h r i N l a
heimskringlunni	h ei m s k r i N l Y n I
heimsmeistarakeppni	h ei m s m ei s t a r a c_h E h p n I
heimsmeistarakeppnin	h ei m s m ei s t a r a c_h E h p n I n
heimsmeistarakeppnina	h ei m s m ei s t a r a c_h E h p n I n a
heimsmeistarakeppninnar	h ei m s m ei s t a r a c_h E h p n I n a r
heimsmælikvarða	h ei m s m ai l I k_h v a r D a
heimspekideild	h ei m s p E c I t ei l t
heimsveldi	h ei m s v E l t I
heimsókninni	h ei m s ou h k n I n I
heimta	h ei m_0 t a
heimtar	h ei m_0 t a r
heimtaugar	h ei m t_h 9i G a r
heimtingu	h ei m_0 t i N k Y
heimtuðu	h ei m_0 t Y D Y
heitasta	h ei: t a s t a
heitnum	h ei h t n Y m
heiðan	h ei: D a n
heiðarlegri	h ei: D a r l E G r I
heiðmörk	h ei D m 9 r_0 k
heiðursfélagi	h ei: D Y r_0 s f j E l ai j I
heklusport	h E h k l Y s p O r_0 t
hektara	h E x t a r a
hekturum	h E x t Y r Y m
hektó	h E x t ou
helgarhopp	h E l k a r h O h p
helgaropnun	h E l k a r O h p n Y n
helgarstemmningu	h E l k a r_0 s t E m n i N k Y
helgisöngvar	h E l c I s 9i N k v a r
heljarstökk	h E l j a r_0 s t 9 h k
hellingur	h E t l i N k Y r
hellinum	h E t l I n Y m
hellisins	h E t l I s I n s
hellt	h E l_0 t
hellti	h E l_0 t I
helltum	h E l_0 t Y m
helltust	h E l_0 t Y s t
hellunni	h E t l Y n I
helminginn	h E l m i J c I n
helmingnum	h E l m i N n Y m
helsinki	h E l s i J_0 c I
heltók	h E l t_h ou k
hempu	h E m_0 p Y
hendingskasti	h E n t i N s k_h a s t I
hendinni	h E n t I n I
hengd	h ei N t
hengdi	h ei N t I
hengi	h ei J c I
henta	h E n_0 t a
hentisemi	h E n_0 t I s E m I
hentugt	h E n_0 t Y x t
hentuðu	h E n_0 t Y D Y
heppilegra	h E h p I l E G r a
heppilegur	h E h p I l E G Y r
heppnast	h E h p n a s t
heppnað	h E h p n a D
heppni	h E h p n I
heppnin	h E h p n I n
herbertsson	h E r p E r_0 t s O n
herfi	h E r v I
herflugvélar	h E r f l Y G v j E l a r
herforingi	h E r_0 f O r i J c I
herforinginn	h E r_0 f O r i J c I n
herforingjum	h E r_0 f O r i J c Y m
herjólfs	h E r j ou l f s
herkjum	h E r_0 c Y m
herkúles	h E r_0 k u l E s
hermenn	h E r m E n
hernaðarlega	h E r t n a D a r l E G a
hernaði	h E r t n a D I
herpast	h E r_0 p a s t
herpes	h E r_0 p E s
herpist	h E r_0 p I s t
herprestinn	h E r p_h r E s t I n
herprestsins	h E: r p_h r E s t s I n s
herpresturinn	h E: r p_h r E s t Y r I n
herptar	h E r_0 t a r
herptist	h E r_0 t I s t
herra	h E r a
herramaður	h E r a m a D Y r
herrans	h E r a n s
herranæturleikritið	h E r a n ai t Y r l ei k r I t I D
herráðsins	h E r au D s I n s
herréttinum	h E r j E h t I n Y m
hersat	h E r_0 s a t
hershöfðingja	h E r_0 s h 9 v D i J c a
herskip	h E r_0 s c I p
herskipin	h E r_0 s c I p I n
herskálakamp	h E r_0 s k au l a k a m_0 p
herskólakampi	h E r_0 s k ou l a k_h a m_0 p I
herslumuninn	h E r_0 s t l Y m Y n I n
herstjóri	h E r_0 s t j ou r I
herstjórnarskrifstofunni	h E r_0 s t j ou r t n a r_0 s k r I f s t O v Y n I
herstöðvum	h E r_0 s t 9 D v Y m
heræfingar	h E: r ai v i N k a r
hest	h E s t
hestakerrur	h E s t a c_h E r Y r
hestasveinninn	h E s t a s v ei t n I n
hesti	h E s t I
hestsins	h E s t s I n s
hetjurnar	h E: t j Y r t n a r
heygafflar	h ei: k a f l a r
hiklausan	h I: k l 9i s a n
himinhvolfsins	h I: m I n k_h v O l f s I n s
himnalagi	h I m n a l ai j I
himneska	h I m n E s k a
hindrar	h I n t r a r
hinkra	h i N_0 k r a
hinnar	h I n a r
hirslur	h I r_0 s t l Y r
hirtu	h I r_0 t Y
hitabelti	h I: t a p E l_0 t I
hitabeltinu	h I: t a p E l_0 t I n Y
hitakröfur	h I: t a k_h r 9 v Y r
hitalampa	h I: t a l a m_0 p a
hitnar	h I h t n a r
hitnaði	h I h t n a D I
hitti	h I h t I
hið	h I: D
hjakka	C a h k a
hjala	C a: l a
hjalaði	C a: l a D I
hjali	C a: l I
hjallabraut	C a t l a p r 9i t
hjallakirkja	C a t l a c_h I r_0 c a
hjartagæsku	C a r_0 t a c ai s k Y
hjartahlýir	C a r_0 t a l_0 i I r
hjartahlýju	C a r_0 t a l_0 i j Y
hjartahnoð	C a r_0 t a n_0 O D
hjartalags	C a r_0 t a l a x s
hjartans	C a r_0 t a n s
hjartasjúkdóma	C a r_0 t a s j u k t ou m a
hjartasjúkdómum	C a r_0 t a s j u k t ou m Y m
hjartasjúklingar	C a r_0 t a s j u h k l i N k a r
hjartavernd	C a r_0 t a v E r n t
hjartaverndar	C a r_0 t a v E r n t a r
hjartaáfall	C a r_0 t a au f a t l_0
hjartnæm	C a r_0 t n ai m
hjartslátturinn	C a r_0 t s t l au h t Y r I n
hjálm	C au l m
hjálma	C au l m a
hjálminn	C au l m I n
hjálmsdýpis	C au l m s t i p I s
hjálmtý	C au l m t_h i
hjálmum	C au l m Y m
hjálpa	C au l_0 p a
hjálpar	C au l_0 p a r
hjálparaðila	C au l_0 p a r a D I l a
hjálpargögn	C au l_0 p a r k 9 k n_0
hjálpargögnum	C au l_0 p a r k 9 k n Y m
hjálparhönd	C au l_0 p a r h 9 n t
hjálparlaus	C au l_0 p a r l 9i s
hjálparmæður	C au l_0 p a r m ai D Y r
hjálparstarf	C au l_0 p a r s t a r f
hjálparstarfi	C au l_0 p a r_0 s t a r v I
hjálparstarfs	C au l_0 p a r_0 s t a r f s
hjálparstarfsins	C au l_0 p a r_0 s t a r f s I n s
hjálparstofnana	C au l_0 p a r_0 s t O p n a n a
hjálparsveit	C au l_0 p a r_0 s v ei t
hjálparsögnina	C au l_0 p a r_0 s 9 k n I n a
hjálparsögninni	C au l_0 p a r s 9 k n I n I
hjálparvana	C au l_0 p a r v a n a
hjálpast	C au l_0 p a s t
hjálpað	C au l_0 p a D
hjálpaði	C au l_0 p a D I
hjálpi	C au l_0 p I
hjálpin	C au l_0 p I n
hjálpina	C au l_0 p I n a
hjálpsamra	C au l_0 p s a m r a
hjálpsamt	C au l_0 p s a m_0 t
hjálpsamur	C au l_0 p s a m Y r
hjálpsemi	C au l_0 p s E m I
hjálpum	C au l_0 p Y m
hjálpuðu	C au l p Y D Y
hjálpuðum	C au l_0 p Y D Y m
hjáverkum	C au: v E r_0 k Y m
hjó	C ou:
hjóla	C ou: l a
hjólafólki	C ou: l a f ou l_0 c I
hjólandi	C ou: l a n t I
hjólastellið	C ou: l a s t E l I D
hjólastillingarbúnað	C ou: l a s t I t l i N k a r p u n a D
hjólbörur	C ou l p 9 r Y r
hjólbörðum	C ou l p 9 r D Y m
hjólhestsins	C ou l h E s t s I n s
hjólkróna	C ou l_0 k_h r ou n a
hjörleifsdóttir	C 9 r l ei f s t ou h t I r
hjörts	C 9 r_0 t s
hjúkrunardeild	C u: k r Y n a r t ei l t
hjúkrunarráð	C u k r Y n a r au D
hlakka	l_0 a h k a
hlakkaði	l_0 a h k a D I
hlamma	l_0 a m a
hlammaði	l_0 a m a D I
hlandi	l_0 a n t I
hlaupabólu	l_0 9i: p a p ou l Y
hlaupara	l_0 9i: p a r a
hlaupinn	l_0 9i: p I n
hlaupið	l_0 9i: p I D
hlaupsins	l_0 9i p s I n s
hlaupum	l_0 9i: p Y m
hlaðborðið	l_0 a D p O r D I D
hlaðna	l_0 a D n a
hlekkir	l_0 E h c I r
hlekkjaður	l_0 E h c a D Y r
hlekkjum	l_0 E h c Y m
hlekkjuð	l_0 E h c Y D
hlerað	l_0 E: r a D
hlerum	l_0 E: r Y m
hlerunum	l_0 E: r O n Y m
hleypir	l_0 ei: p I r
hleðslugaffals	l_0 E D s t l Y G a f a l s
hliðargötu	l_0 I: D a r k 9 t Y
hliðarrúða	l_0 I: D a r u D a
hliðarrúðunum	l_0 I: D a r u D Y n Y m
hliðartösku	l_0 I: D a r_0 t_h 9 s k Y
hliðstæður	l_0 I D s t ai D Y r
hliðunum	l_0 I: D O n Y m
hljómað	l_0 j ou: m a D
hljómfalli	l_0 j ou: m f a t l I
hljómkviðu	l_0 j ou m k_h v I D Y
hljómlausri	l_0 j ou m l 9i s r I
hljómlaust	l_0 j ou m l 9i s t
hljómplötu	l_0 j ou m p_h l 9 t Y
hljómplötum	l_0 j ou m p_h l 9 t Y m
hljómskífa	l_0 j ou m s c i v a
hljómsveitar	l_0 j ou m s v ei t a r
hljómsveitavænasta	l_0 j ou m s v ei t a v ai n a s t a
hljómsveitina	l_0 j ou m s v ei t I n a
hljótt	l_0 j ou h t
hljóð	l_0 j ou: D
hljóða	l_0 j ou: D a
hljóðeinangrunarplötum	l_0 j ou: D ei n au N k r Y n a r_0 p_h l 9 t Y m
hljóðfæraskipan	l_0 j ou D f ai r a s c I p a n
hljóðin	l_0 j ou: D I n
hljóðið	l_0 j ou: D I D
hljóðkerfi	l_0 j ou D c_h E r v I
hljóðlaus	l_0 j ou D l 9i s
hljóðlaust	l_0 j ou D l 9i s t
hljóðlátt	l_0 j ou D l au h t
hljóðnar	l_0 j ou D n a r
hljóðnemann	l_0 j ou D n E m a n
hljóðnuðu	l_0 j ou D n Y D Y
hljóðritanir	l_0 j ou D r I t a n I r
hljóðvinnsluforrits	l_0 j ou D v I n s t l Y f O r I t s
hlunk	l_0 u N_0 k
hlunkast	l_0 u N_0 k a s t
hlunkaðist	l_0 u N_0 k a D I s t
hlunki	l_0 u J_0 c I
hlunkur	l_0 u N_0 k Y r
hlutafélagi	l_0 Y: t a f j E l ai j I
hlutfall	l_0 Y t f a t l_0
hlutfallskvarða	l_0 Y: t f a l s k_h v a r D a
hlutfallslegan	l_0 Y t f a l s t l E G a n
hlutfallslegri	l_0 Y t f a l s t l E G r I
hlutföllum	l_0 Y: t f 9 t l_0 Y m
hluthyggja	l_0 Y t_h I c a
hlutleysi	l_0 Y h t l ei s I
hluttekningu	l_0 Y t_h E h k n i N k Y
hlutverki	l_0 Y: t v E r_0 c I
hlutverkin	l_0 Y: t v E r_0 c I n
hlykkjótt	l_0 I h c ou h t
hláturs	l_0 au: t Y r_0 s
hlægilegt	l_0 ai: j I l E x t
hlé	l_0 j E:
hlédrægur	l_0 j E t r ai G Y r
hlégarði	l_0 j E: k a r D I
hlés	l_0 j E: s
hléum	l_0 j E: Y m
hlífar	l_0 i: v a r
hlíðartúni	l_0 i: D a r_0 t_h u n I
hlógu	l_0 ou: G Y
hlökkum	l_0 9 h k Y m
hlöðversdóttir	l_0 9 D v E r_0 s t ou h t I r
hlýrra	l_0 i r a
hnakkann	n_0 a h k a n
hnakkanum	n_0 a h k a n Y m
hnakkefni	n_0 a h c E p n I
hnakkinn	n_0 a h c I n
hnakknefið	n_0 a h k n E v I D
hnappa	n_0 a h p a
hnappana	n_0 a h p a n a
hnappavöllum	n_0 a h p a v 9 t l Y m
hnarreist	n_0 a r ei s t
hnattvædd	n_0 a h t v ai t
hnattvæðingu	n_0 a h t v ai D i N k Y
hnefaleika	n_0 E: v a l ei k a
hnefaleikum	n_0 E: v a l ei k Y m
hnefana	n_0 E: v a n a
hnefann	n_0 E: v a n
hnefanum	n_0 E: v a n Y m
hnefinn	n_0 E: v I n
hnefum	n_0 E: v Y m
hneig	n_0 ei: G
hneisu	n_0 ei: s Y
hnekk	n_0 E h k
hnekkja	n_0 E h c a
hnekkt	n_0 E x t
hneppir	n_0 E h p I r
hnepptur	n_0 E f t Y r
hnerra	n_0 E r a
hnettinum	n_0 E h t I n Y m
hnettir	n_0 E h t I r
hnetu	n_0 E: t Y
hnetum	n_0 E: t Y m
hnetur	n_0 E: t Y r
hnetusmjör	n_0 E: t Y s m j 9 r
hneykslan	n_0 ei k s t l a n
hneykslast	n_0 ei k s t l a s t
hneykslaður	n_0 ei k s t l a D Y r
hneyksli	n_0 ei k s t l I
hneyksluð	n_0 ei k s t l Y D
hnigið	n_0 I: j I D
hnigu	n_0 I: G Y
hnikaði	n_0 I: k a D I
hnippa	n_0 I h p a
hnippt	n_0 I f t
hnitmiðað	n_0 I t m I D a D
hnitmiðaða	n_0 I: t m I D a D a
hnituðu	n_0 I: t Y D Y
hnjánna	n_0 j au t n a
hnullunga	n_0 Y t l u N k a
hnullungagrjóti	n_0 Y t l u N k a k r j ou t I
hnykkti	n_0 I x t I
hnyttin	n_0 I h t I n
hné	n_0 j E:
hnífa	n_0 i: v a
hnífapör	n_0 i: v a p_h 9 r
hnífapörin	n_0 i: v a p_h 9 r I n
hnífnum	n_0 i p n Y m
hnífsdals	n_0 i f s t a l s
hnífurinn	n_0 i: v Y r I n
hnýttust	n_0 i h t Y s t
hobbitanum	h O p I t a n Y m
hoffell	h O f E t l_0
holds	h O l t s
hollands	h O l a n t s
hollendingnum	h O l E n t i N n Y m
hollendingurinn	h O l E n t i N k Y r I n
hollustuvernd	h O t l Y s t Y v E r n t
hollustuverndar	h O t l Y s t Y v E r n t a r
holtsgötu	h O l_0 t s k 9 t Y
holtsmúla	h O l_0 t s m u l a
holukeppni	h O: l Y c_h E h p n I
hommar	h O m a r
homminn	h O m I n
hoppar	h O h p a r
hoppað	h O h p a D
horfna	h O r t n a
horfnar	h O r t n a r
horfnir	h O r t n I r
horfði	h O r D I
horfðir	h O r D I r
horfðumst	h O r D Y m s t
hornsteinn	h O r t n s t ei t n_0
hornsteinum	h O r t n_0 s t ei n Y m
hrafnkell	r_0 a p c_h E t l_0
hrafnkels	r_0 a p n_0 c_h E l s
hrafnkelsson	r_0 a p n_0 c_h E l s O n
hrafns	r_0 a p n_0 s
hrafnseyri	r_0 a p n_0 s ei r I
hrafnsvart	r_0 a p n_0 s v a r_0 t
hrakti	r_0 a x t I
hramminn	r_0 a m I n
hrannast	r_0 a n a s t
hrapa	r_0 a: p a
hrapaði	r_0 a: p a D I
hrapp	r_0 a h p
hrappsey	r_0 a h p s ei
hrasa	r_0 a: s a
hrasaði	r_0 a: s a D I
hraunbollum	r_0 9i n p O t l Y m
hraungrýti	r_0 9i N k r i t I
hraus	r_0 9i: s
hraustur	r_0 9i s t Y r
hraðakstur	r_0 a: D a k s t Y r
hraðaksturs	r_0 a: D a k s t Y r_0 s
hraðastilli	r_0 a: D a s t I t l I
hraðaði	r_0 a: D a D I
hraðbanka	r_0 a D p au N_0 k a
hraðboði	r_0 a: D p O D I
hraðfrystihúsanna	r_0 a D f r I s t I h u s a n a
hraðlestinni	r_0 a D l E s t I n I
hraðmæltur	r_0 a D m ai l_0 t Y r
hrefna	r_0 E p n a
hreggviðssyni	r_0 E k v I D s I n I
hreggviður	r_0 E k v I D Y r
hreina	r_0 ei: n a
hreinan	r_0 ei: n a n
hreinna	r_0 ei t n a
hreinni	r_0 ei t n I
hreinsitækni	r_0 ei n s I t ai h k n I
hreinskilin	r_0 ei n s c I l I n
hreinskiptinn	r_0 ei n s c I f t I n
hreinum	r_0 ei: n Y m
hrekk	r_0 E h k
hrekkjusvín	r_0 E h c Y s v i n
hrekkjótt	r_0 E h c ou h t
hremma	r_0 E m a
hreppi	r_0 E h p I
hreppsnefnd	r_0 E h p s t n E m t
hreppsnefndar	r_0 E h p s t n E m t a r
hrepptu	r_0 E f t Y
hressa	r_0 E s a
hressandi	r_0 E s a n t I
hressari	r_0 E s a r I
hressileg	r_0 E s I l E G
hressilegur	r_0 E s I l E G Y r
hreyfiafli	r_0 ei: v I a p l I
hreyfilandi	r_0 ei: v I l a n t I
hreyfilsins	r_0 ei: v I l s I n s
hreyfingarlausir	r_0 ei: v i N k a r l 9i s I r
hreyft	r_0 ei f t
hreyfðu	r_0 ei v D Y
hreysi	r_0 ei: s I
hreysinu	r_0 ei: s I n Y
hreysið	r_0 ei: s I D
hreyta	r_0 ei: t a
hrifinn	r_0 I: v I n
hrifningin	r_0 I p n i J c I n
hrifsar	r_0 I f s a r
hrikti	r_0 I x t I
hrindir	r_0 I n t I r
hringadróttinssögu	r_0 i N k a t r ou h t I n s 9 G Y
hringdans	r_0 i N k t a n s
hringdi	r_0 i N t I
hringdu	r_0 i N t Y
hringferð	r_0 i N k f E r D
hringina	r_0 i J c I n a
hringja	r_0 i J c a
hringlaga	r_0 i N k l a G a
hringnum	r_0 i N n Y m
hrings	r_0 i N s
hringsneri	r_0 i N s t n j E r I
hringsnýst	r_0 i N k s t n i s t
hringstiga	r_0 i N k s t I G a
hringsólaði	r_0 i N k s ou l a D I
hringtorg	r_0 i N k t_h O r k
hrjúfur	r_0 j u: v Y r
hrokafullt	r_0 O: k a f Y l_0 t
hrossi	r_0 O s I
hrossunum	r_0 O s O n Y m
hrukkum	r_0 Y h k Y m
hryggigt	r_0 I c I x t
hryggvöðva	r_0 I k v 9 D v a
hrykki	r_0 I h c I
hryllingi	r_0 I t l i J c I
hryllti	r_0 I l_0 t I
hryssingslega	r_0 I s i N s t l E G a
hryssur	r_0 I s Y r
hryðjuverkasamtakanna	r_0 I D j Y v E r_0 k a s a m t_h a k a n a
hrá	r_0 au:
hráki	r_0 au: c I
hrædd	r_0 ai t
hrærigraut	r_0 ai: r I k r 9i t
hrísgrjónaökrum	r_0 i s k r j ou n a 9 k r Y m
hróarskeldu	r_0 ou: a r_0 s c E l t Y
hróarskelduhátíðinni	r_0 ou: a r_0 s c E l t Y h au t i D I n I
hróbjartsson	r_0 ou p j a r_0 t s O n
hröktu	r_0 9 x t Y
hrúðurflétta	r_0 u: D Y r_0 f l j E h t a
hugarflug	h Y: G a r f l Y G
hugarlund	h Y: G a r l Y n t
hugarró	h Y: G a r ou
hugarástand	h Y: G a r au s t a n t
huggandi	h Y k a n t I
huggar	h Y k a r
hugguleg	h Y k Y l E G
huggulegri	h Y k Y l E G r I
huggulegt	h Y k Y l E x t
huggunarorðum	h Y k Y n a r O r D Y m
hugkvæmst	h Y G k_h v ai m s t
hugleiðingu	h Y G l ei D i N k Y
hugljúfi	h Y G l j u v I
hugrekki	h Y G r E h c I
hugrökk	h Y G r 9 h k
hugsanakrafts	h Y k s a n a k_h r a f t s
hugsanlegri	h Y k s a n l E G r I
hugvekju	h Y G v E c Y
hugðarefnum	h Y G D a r E p n Y m
hugði	h Y G D I
hull	h Y t l
humarbragð	h Y: m a r p r a G D
humm	h Y m
humma	h Y m a
hundagöngunni	h Y n t a k 9i N k Y n I
hundleiðinlegt	h Y n t l ei D I n l E x t
hundpúkaleiðinlegir	h Y n t p u k a l ei D I n l ei j I r
hundraðkall	h Y n t r a T k_h a t l_0
hundsa	h Y n t s a
hungursneyð	h u N k Y r s t n ei D
hungurvofan	h u N k Y r v O v a n
hungurvöku	h u N k Y r v 9 k Y
hvalaskoðunarferðir	k_h v a: l a s k O D Y n a r_0 f E r D I r
hvaleyrarholtsvelli	k_h v a: l ei r a r_0 h O l_0 t s v E t l I
hvalfjarðargöngin	k_h v a l f j a r D a r k 9i J c I n
hvalina	k_h v a: l I n a
hvalveiðum	k_h v a l v ei D Y m
hvamminn	k_h v a m I n
hvarflandi	k_h v a r t l a n t I
hvarflar	k_h v a r t l a r
hvarflað	k_h v a r t l a D
hvarflaði	k_h v a r t l a D I
hvarfslóð	k_h v a r f s t l ou D
hvass	k_h v a s
hvassa	k_h v a s a
hvassar	k_h v a s a r
hvati	k_h v a: t I
hvatinn	k_h v a: t I n
hvatning	k_h v a h t n I N k
hvatningin	k_h v a h t n I J c I n
hvatningu	k_h v a h t n I N k Y
hvatti	k_h v a h t I
hvaða	k_h v a: D a
hvaðanæva	k_h v a: D a n ai v a
hvaðeina	k_h v a: D ei n a
hveitikímsolía	k_h v ei: t I c_h i m s O l i j a
hvelfinguna	k_h v E l f i N k Y n a
hveli	k_h v E: l I
hveljur	k_h v E l j Y r
hvell	k_h v E t l
hvellinn	k_h v E t l I n
hvellri	k_h v E t l r I
hvellt	k_h v E l_0 t
hvellur	k_h v E t l Y r
hvellurinn	k_h v E t l Y r I n
hverf	k_h v E r f
hverfandi	k_h v E r v a n t I
hverfinu	k_h v E r v I n Y
hverfisins	k_h v E r v I s I n s
hverfisráð	k_h v E r v I s r au D
hverfissamtakanna	k_h v E r v I s a m t_h a k a n a
hverfli	k_h v E r t l I
hverfult	k_h v E r v Y l_0 t
hverfur	k_h v E r v Y r
hvergi	k_h v E r c I
hverjum	k_h v E r j Y m
hverra	k_h v E r a
hverri	k_h v E r I
hversdagslegt	k_h v E r_0 s t a x s t l E x t
hversdagsleikann	k_h v E r_0 s t a x s t l ei k a n
hversdagsleiknum	k_h v E r_0 s t a x s t l ei h k n Y m
hversins	k_h v E r_0 s I n s
hverslags	k_h v E r_0 s t l a x s
hvessi	k_h v E s I
hvessir	k_h v E s I r
hvetjandi	k_h v E: t j a n t I
hvikaði	k_h v I: k a D I
hvinur	k_h v I: n Y r
hvirflinum	k_h v I r t l I n Y m
hviss	k_h v I s
hvolfdi	k_h v O l t I
hvolfdist	k_h v O l t I s t
hvolft	k_h v O l_0 t
hvolpa	k_h v O l_0 p a
hvolpana	k_h v O l_0 p a n a
hvolpinn	k_h v O l_0 p I n
hvolpinum	k_h v O l_0 p I n Y m
hvorrar	k_h v O r a r
hvorri	k_h v O r I
hvorttveggja	k_h v O r_0 t_h v E c a
hvæsandi	k_h v ai: s a n t I
hví	k_h v i:
hvíl	k_h v i: l
hvíldar	k_h v i l t a r
hvíldardeginum	k_h v i l t a r t ei j I n Y m
hvíldarpúls	k_h v i l t a r_0 p_h u l s
hvíldinni	k_h v i l t I n I
hvílíkt	k_h v i: l i x t
hvíslaði	k_h v i s t l a D I
hvíslið	k_h v i s t l I D
hvítasunnudag	k_h v i: t a s Y n Y t a G
hvítasunnumenn	k_h v i: t a s Y n Y m E n
hvítlakkaðar	k_h v i: t l a h k a D a r
hvítlauksrifin	k_h v i t l 9i k s r I v I n
hvítra	k_h v i: t r a
hvítsmárann	k_h v i t s m au r a n
hvöss	k_h v 9 s
hvötum	k_h v 9: t Y m
hyggilegast	h I c I l E G a s t
hyggjast	h I c a s t
hyperlinkurinn	h ai: p E r l i N_0 k Y r I n
hádegi	h au: t ei j I
hádegisfréttir	h au: t ei j I s f r j E h t I r
hádegisverðar	h au: t ei j I s v E r D a r
hádegisverði	h au: t ei j I s v E r D I
hádegisverður	h au: t ei j I s v E r D Y r
háholti	h au: h O l_0 t I
hákarl	h au: k_h a r t l
hálfdanarson	h au l t a n a r s O n
hálfdán	h au l v t au n
hálffimm	h au l f I m
hálffull	h au l f Y t l_0
hálfnaður	h au l n a D Y r
hálfopnum	h au l v O h p n Y m
hálfrar	h au l v r a r
hálfri	h au l v r I
hálfrökkrinu	h au l v r 9 h k r I n Y
hálft	h au l_0 t
hálftíma	h au l t_h i m a
hálftíu	h au l f t_h i j Y
hálftólf	h au l f t_h ou l f
hálftómum	h au l t_h ou m Y m
hálka	h au l_0 k a
háloftunum	h au: l O f t O n Y m
hámarks	h au: m a r_0 k s
hámarksgreiðslugeta	h au: m a r_0 k s k r ei D s t l Y c E t a
hámarkshraða	h au: m a r_0 k s r_0 a D a
hápunkti	h au: p u n_0 t I
hárkollu	h au r k_h O t l Y
hárlýjur	h au r l i j Y r
háskólanema	h au: s k ou l a n E m a
háskólapróf	h au s k ou l a p_h r ou f
háskólasvæðinu	h au: s k ou l a s v ai D I n Y
hásri	h au: s r I
háteigskirkju	h au: t_h ei x s c_h I r_0 c Y
háteigssóknar	h au: t_h ei x s ou h k n a r
háttalag	h au h t a l a G
hávaxinn	h au: v a k s I n
hægra	h ai G r a
hægrimanna	h ai G r I m a n a
hægt	h ai x t
hægð	h ai G D
hægðist	h ai G D I s t
hækkaðir	h ai h k a D I r
hækkun	h ai h k Y n
hænsnin	h ai n s t n I n
hærra	h ai r a
hæstaréttarlögmanns	h ai s t a r j E h t a r_0 l 9 G m a n s
hæstiréttur	h ai s t I r j E h t Y r
hættulegustu	h ai h t Y l E G Y s t Y
hættunni	h ai h t Y n I
hæversku	h ai: v E r_0 s k Y
hégóma	C E: G ou m a
hégóminn	C E: k ou m I n
héldi	C E l t I
héldu	C E l t Y
héldum	C E l t Y m
héldust	C E l t Y s t
hélduð	h j E l t Y D
hélst	C E l s t
héngi	C ei J c I
héngu	C ei N k Y
hérað	C E: r a D
héraði	C E: r a D I
héraðinu	C E: r a D I n Y
héraðsdómi	C E: r a D s t ou m I
héraðsdóms	C E: r a D s t ou m s
héraðsins	C E: r a D s I n s
héraðslæknirinn	C E: r a D s t l ai h k n I r I n
héruð	C E: r Y D
héti	C E: t I
hétum	C E: t Y m
héðan	C E: D a n
hóflegt	h ou v l E x t
hófsemi	h ou f s E m I
hófu	h ou: v Y
hófum	h ou: v Y m
hófust	h ou: v Y s t
hólmsteinn	h ou l m s t ei t n_0
hólpinn	h ou l_0 p I n
hópnum	h ou h p n Y m
hótaði	h ou: t a D I
höfuðkúpan	h 9: v Y D k_h u p a n
höfuðkúpuna	h 9: v Y D k_h u p Y n a
höfðalagið	h 9 v D a l ai j I D
höfðinginn	h 9 v D i J c I n
höggi	h 9 c I
höggið	h 9 c I D
höggmynd	h 9 k m I n t
höggunum	h 9 k O n Y m
höggvin	h 9 k v I n
höggvinn	h 9 k v I n
höggvið	h 9 k v I D
hökti	h 9 x t I
höllin	h 9 t l I n
hönnunina	h 9 n Y n I n a
hörmungum	h 9 r m u N k Y m
húfu	h u: v Y
húkti	h u x t I
húnavatnssýslu	h u: n a v a s i s t l Y
húnaþingi	h u: n a T i J c I
húrra	h u r a
húsakynnin	h u: a c_h I n I n
húsbyggingar	h u: s p I c i N k a r
húsnæðismál	h u s t n ai D I s m au l
húsnæðisvanda	h u s t n ai D I s v a n t a
húsráðanda	h u: s r au D a n t a
húsráðandi	h u: s r au D a n t I
húsráðendur	h u: s r au D E n t Y r
húsrúm	h u: s r u m
húsvegginn	h u: s v E c I n
húsverðinum	h u: s v E r D I n Y m
húsvörðinn	h u: s v 9 r D I n
húsvörður	h u: s v 9 r D Y r
iktsýki	I x t s i c I
ill	I t l_0
illan	I t l a n
illkvittni	I t l k_h v I h t n I
illmögulegt	I t l m 9 G Y l E x t
ills	I l s
illsku	I l s k Y
illskulega	I l s k Y l E G a
illskuna	I l s k Y n a
illskunni	I l s k Y n I
illskuríkt	I l s k Y r i x t
illt	I l_0 t
illugi	I t l Yi j I
illviðri	I t l v I D r I
illviðráðanlegri	I t l_0 v I D r au D a n l E G r I
ilmvötn	I l m v 9 h t n_0
impregilo	I: m p_h r E c i l O
indlands	I n t l a n t s
indussléttunum	I n t Y s t l j E h t O n Y m
indverski	I n t v E r_0 s c I
indverskir	I n t v E r_0 s c I r
indæll	I n t ai t l_0
ingibergsdóttir	i J c I p E r k s t ou h t I r
ingileif	i J c I l ei v
ingólfs	i N k ou l f s
ingólfsdóttur	i N k ou l f s t ou h t Y r
ingólfsson	i N k ou l f s O n
ingólfssyni	i N k ou l f s I n I
ingólfstorg	i N k ou l f s t_h O r k
ingólfstorgi	i N k ou l f s t_h O r c I
innangengt	I n a n c ei N_0 t
innanlandsflugi	I n a n l a n t s f l Yi j I
innanlandsfluginu	I n a n l a n t s f l Yi j I n Y
innanlandsmarkaði	I n a n l a n s m a r_0 k a D I
innanríkisráðherra	I n a n r i c I s r au D h E r a
innanríkisráðuneytinu	I n a n r i c I s r au D Y n ei t I n Y
innfæddum	I n f ai t Y m
innfæddur	I n f ai t Y r
innfærslu	I n f ai r_0 s t l Y
inngangs	I N k au N s
inngangsins	I N k au N s I n s
inngönguhurðir	I n k 9i N k Y h Y r D I r
innheimtu	I n h ei m_0 t Y
innheimtuna	I n h ei m_0 t Y n a
innilegt	I n I l E x t
innilegu	I n I l E G Y
innilokunarkennd	I n I l O k Y n a r_0 c_h E n t
innkalla	I N k_h a t l a
innkeyrslu	I J c_h ei r_0 s t l Y
innkeyrsluna	I n n c_h ei r_0 s t l Y n a
innkirtlasérfræðingurinn	I J c_h I r_0 t l a s j E r_0 f r ai D i N k Y r I n
innlausnar	I n l 9i s t n a r
innleiðingu	I n l ei D i N k Y
innrammaða	I n r a m a D a
innréttað	I n r j E h t a D
innréttingum	I n r j E h t i N k Y m
innspýtingu	I n s p i t i N k Y
innst	I n s t
innstreymisvatn	I n s t r ei m I s v a h t n_0
inntakið	I n t_h a c I D
inntökupróf	I n t_h 9 k Y p r ou f
intel	I n t_h E l
internet	I n_0 t E r n E t
iðkun	I T k Y n
iðunnar	I: D Y n a r
jafngildi	j a p c I l t I
jafnmiklum	j a p n_0 m I h k l Y m
jafnræðisreglu	j a p r ai D I s r E k l Y
jafnréttis	j a p n_0 r j E h t I s
jafnréttisráðgjafi	j a p n_0 r j E h t I s r au D c a v I
jafnréttisstofa	j a p n_0 r j E h t I s t O v a
jafnréttisstofu	j a p n_0 r j E h t I s t O v Y
jafnskjótt	j a p n_0 s c ou h t
jafnsléttu	j a p n_0 s t l j E h t Y
jafnstór	j a p n_0 s t ou r
jafntefli	j a p t_h E p l I
jafnóðum	j a p n ou D Y m
jakkavasann	j a h k a v a s a n
jamm	j a m
japl	j a h p l
jarðarberjakaffi	j a r D a r p E r j a k_h a f I
jarðefnabirgðir	j a r D E p n a p I r D I r
jarðgöng	j a r D k 9i N k
jarðneska	j a r D n E s k a
jarðskjálftamælar	j a r D s c au l_0 t a m ai l a r
jarðskjálftanum	j a r D s c au l_0 t a n Y m
jarðskjálftinn	j a r D s c au l_0 t I n
jarðyrkjuverkfæri	j a r D I r_0 c Y v E r_0 k f ai r I
javaskrift	j a: v a s k r I f t
jaxlinn	j a k s t l I n
jeppar	j E h p a r
jákvætt	j au: k_h v ai h t
jákvæð	j au: k_h v ai D
jákvæða	j au: k_h v ai D a
jákvæðan	j au: k_h v ai D a n
jákvæðni	j au: k_h v ai D n I
jákvæðu	j au: k_h v ai D Y
jákvæðum	j au: k_h v ai D Y m
jákvæður	j au: k_h v ai D Y r
járnbrautarteinunum	j au t n_0 p r 9i t a t_h ei n O n Y m
járnsmið	j au r t n_0 s m I D
járntjaldið	j au r t n_0 t_h j a l t I D
játningar	j au h t n i N k a r
jóhannesson	j ou: h a n E s O n
jóhannssyni	j ou: h a n s I n I
jólasveinar	j ou: l a s v ei n a r
jólasveinninn	j ou: l a s v ei t n I n
jónasson	j ou: n a s O n
jónassonar	j ou: n a s O n a r
jónatan	j ou: n a t a n
jónsdóttur	j ou n s t ou h t Y r
jónsmessu	j ou n s m E s Y
jósefsspítali	j ou: s E f s p i t a l I
jótlandi	j ou t l a n t I
jöfnum	j 9 p n Y m
jöfnuður	j 9 p n Y D Y r
jökla	j 9 h k l a
kafað	k_h a: v a D
kaffi	k_h a f I
kaffibolla	k_h a f I p O t l a
kaffibollanum	k_h a f I p O t l a n Y m
kaffibollum	k_h a f I p O t l Y m
kaffiboð	k_h a f I p O D
kaffihlaðborð	k_h a f I l_0 a D p O r D
kaffihlé	k_h a f I l_0 j E
kaffihús	k_h a f I h u s
kaffihúsa	k_h a f I h u s a
kaffihúsin	k_h a f I h u s I n
kaffihúsinu	k_h a f I h u s I n Y
kaffihúsið	k_h a f I h u s I D
kaffihúsum	k_h a f I h u s Y m
kaffikanna	k_h a f I k_h a n a
kaffikannan	k_h a f I k_h a n a n
kaffikompunni	k_h a f I k_h O m_0 p Y n I
kaffikönnuna	k_h a f I k_h 9 n Y n a
kaffikönnunni	k_h a f I k_h 9 n Y n I
kaffileikhúsið	k_h a f I l ei k_h u s I D
kaffinu	k_h a f I n Y
kaffisala	k_h a f I s a l a
kaffisopa	k_h a f I s O p a
kaffisopi	k_h a f I s O p I
kaffispjall	k_h a f I s p j a t l_0
kaffistofa	k_h a f I s t O v a
kaffistofan	k_h a f I s t O v a n
kaffistofu	k_h a f I s t O v Y
kaffistofuna	k_h a f I s t O v Y n a
kaffisölu	k_h a f I s 9 l Y
kaffiveitingar	k_h a f I v ei t i N k a r
kaffivél	k_h a f I v j E l
kaffivélinni	k_h a f I v j E l I n I
kaffið	k_h a f I D
kaffugl	k_h a: f Y k l_0
kaflaheiti	k_h a p l a h ei t I
kaflans	k_h a p l a n s
kaflinn	k_h a p l I n
kafrjóð	k_h a v r j ou D
kaktusum	k_h a x t Y s Y m
kaldhæðinn	k_h a l t h ai D I n
kaldhæðnislegt	k_h a l t h ai D n I s t l E x t
kaldi	k_h a l t I
kaldur	k_h a l t Y r
kalkaðir	k_h a l_0 k a D I r
kalki	k_h a l_0 c I
kalkskeljar	k_h a l_0 k s c E l j a r
kalkúnn	k_h a l_0 k u t n_0
kalkþörungaverksmiðju	k_h a l_0 k T 9 r u N k a v E r_0 k s m I D j Y
kallakvöld	k_h a t l a k_h v 9 l t
kallast	k_h a t l a s t
kallfæri	k_h a t l_0 f ai r I
kallið	k_h a t l I D
kalskemmdir	k_h a l s c E m t I r
kalskemmdum	k_h a: l s c E m t Y m
kambafólkinu	k_h a m p a f ou l_0 c I n Y
kambsins	k_h a m p s I n s
kammerkór	k_h a m E r k_h ou r
kammertónlist	k_h a m E r_0 t_h ou n l I s t
kammerverk	k_h a m E r v E r_0 k
kampavínsflösku	k_h a m_0 p a v i n s f l 9 s k Y
kampinn	k_h a m_0 p I n
kan	k_h a: n
kann	k_h a n
kannabis	k_h a n a p I s
kannanir	k_h a n a n I r
kannaður	k_h a n a D Y r
kanni	k_h a n I
kannski	k_h a n s c I
kannt	k_h a n_0 t
kanínur	k_h a: n i n Y r
kapalinn	k_h a: p a l I n
kapelluna	k_h a: p E t l Y n a
kapellunnar	k_h a: p E t l Y n a r
kaplakrika	k_h a h p l a k_h r I k a
kaplakriki	k_h a h p l a k_h r I c I
kaplaskjólsvegi	k_h a h p l a s c ou l s v ei j I
kappa	k_h a h p a
kappakstur	k_h a h p a k s t Y r
kappans	k_h a h p a n s
kappar	k_h a h p a r
kappkosta	k_h a h p k_h O s t a
kappnóg	k_h a h p n ou G
kapteinn	k_h a f t ei t n
kapítuli	k_h a: p i t_h Y l I
karlaflokki	k_h a r t l a f l O h c I
karlaklósettið	k_h a r t l a k_h l ou s E h t I D
karlakórs	k_h a r t l a k_h ou r_0 s
karlana	k_h a r t l a n a
karlfressið	k_h a r t l f r E s I D
karlgreyið	k_h a r t l k r ei I D
karli	k_h a r t l I
karlinn	k_h a r t l I n
karlmann	k_h a r t l m a n
karlmanna	k_h a r t l m a n a
karlmannlega	k_h a r t l m a n l E G a
karlmannlegur	k_h a r t l m a n l E G Y r
karlmaður	k_h a r t l m a D Y r
karlmennska	k_h a r t l m E n s k a
karlmönnum	k_h a r t l m 9 n Y m
karlmönnunum	k_h a r t l m 9 n O n Y m
karlsdóttur	k_h a l s t ou h t Y r
karlssonar	k a l r t l_0 s O n a r
karmelklaustur	k_h a r m E l k_h l 9i s t Y r
karpatafjöllum	k_h a r_0 p a t a f j 9 t l Y m
karríi	k_h a r i I
kartöflubollur	k_h a r_0 t 9 p l Y p O l Y r
kartöflumauki	k_h a r_0 t 9 p l Y m 9i c I
kartöflustöppu	k_h a r_0 t 9 p l Y s t 9 h p Y
kasjú	k_h a s j u
kassagítar	k_h a s a c i t a r
kassana	k_h a s a n a
kassann	k_h a s a n
kassanum	k_h a s a n Y m
kast	k_h a s t
kastið	k_h a s t I D
kastljós	k_h a s t l j ou s
kaststöng	k_h a s t s t 9i N k
kattasandur	k_h a h t a s a n t Y r
kattholti	k_h a h t O l_0 t I
kaun	k_h 9i: n
kaupa	k_h 9i: p a
kaupangi	k_h 9i: p au J c I
kauphallar	k_h 9i p h a t l a r
kauphöll	k_h 9i p h 9 t l_0
kauphöllinni	k_h 9i p h 9 t l I n I
kaupi	k_h 9i: p I
kauplaust	k_h 9i: p l 9i s t
kaupmenn	k_h 9i h p m E n
kaupmáttarauka	k_h 9i p m au h t a r 9i k a
kauprétt	k_h 9i: p r j E h t
kaupréttarsamninga	k_h 9i: p r j E h t a r s a m n i N k a
kaupskipum	k_h 9i p s c I p Y m
kaupstað	k_h 9i p s t a D
kaupsýslumaður	k_h 9i p s i s t l Y m a D Y r
kaupsýslumenn	k_h 9i p s i s t l Y m E n
kaupverðið	k_h 9i: p v E r D I D
keflavíkurflugvelli	c_h E p l a v i k Y r_0 f Y G v E t l I
keflavíkurflugvöllur	c_h E p l a v i k Y r_0 f l Y G v 9 t l Y r
keilukvöldi	c_h ei: l Y k_h v 9 l t I
keldnaholti	c_h E l t n a h O l_0 t I
kellingar	c_h E t l i N k a r
kellogg	c_h E l O k
kellý	c_h E l i
kempan	c_h E m_0 p a n
kengbogin	c_h ei N k p Oi j I n
kengboginn	c_h ei n k p Oi j I n
kennarana	c_h E n a r a n a
kennaranna	c_h E n a r a n a
kennaraprófi	c_h E n a r a p_h r ou v I
kennarar	c_h E n a r a r
kennarasambandsins	c_h E n a r a s a m p a n t s I n s
kennaraskólann	c_h E n a r a s k ou l a n
kennaratyggjó	c_h E n a r a t_h I c ou
kennaratölva	c_h E n a r a t_h 9 l v a
kennda	c_h E n t a
kenndar	c_h E n t a r
kenninga	c_h E n i N k a
kenningin	c_h E n i J c I n
kennsla	c_h E n s t l a
kennslubækur	c_h E n s t l Y p ai k Y r
kennsluforrit	c_h E n s t l Y f O r I t
kennsluforritum	c_h E n s t l Y f O r I t Y m
kennslugögn	c_h E n s t l Y k 9 k n_0
kennsluskiptum	c_h E n s t l Y s c I f t Y m
kennslustofum	c_h E n s t l Y s t O v Y m
kepp	c_h E h p
keppa	c_h E h p a
keppendur	c_h E h p E n t Y r
keppikefli	c_h E h p I c_h E p l I
keppist	c_h E h p I s t
keppni	c_h E h p n I
keppnin	c_h E h p n I n
keppninnar	c_h E h p n I n a r
keppnisbann	c_h E h p n I s p a n
keppnisdegi	c_h E h p n I s t ei j I
keppnisflokki	c_h E h p n I s f l O h c I
keppnishlé	c_h E h p n I s l_0 j E
keppnislegur	c_h E h p n I s l E G Y r
keppnisliðin	c_h E h p n I s t l I D I n
keppnismaður	c_h E h p n I s m a D Y r
keppnisréttur	c_h E h p n I s r j E h t Y r
keppnistímabilið	c_h E h p n I s t_h i m a p I l I D
keppt	c_h E f t
keppti	c_h E f t I
kepptu	c_h E f t Y
kepptust	c_h E f t Y s t
keramikklúbb	c_h E: r a m I k_h l u p
kerfi	c_h E r v I
kerfisbundin	c_h E r v I s p Y n t I n
kerfisins	c_h E r v I s I n s
kerfisstjórar	c_h E r v I s t j ou r a r
kerjum	c_h E r j Y m
kerlan	c_h E r t l a n
kerlingafjöllum	c_h E r t l i N k a f j 9 t l Y m
kerlingar	c_h E r t l i N k a r
kerrti	c_h E r t I
kerskni	c_h E r_0 s k n I
kertið	c_h E r_0 t I D
kertum	c_h E r_0 t Y m
ketilinn	c_h E: t I l I n
ketti	c_h E h t I
kettlingnum	c_h E h t l i N n Y m
keypta	c_h ei f t a
keyptar	c_h ei f t a r
keyptir	c_h ei f t I r
keyptu	c_h ei f t Y
keðja	c_h E D j a
keðjan	c_h E D j a n
keðju	c_h E D j Y
keðjunnar	c_h E D j Y n a r
keðjur	c_h E D j Y r
keðjureykti	c_h E D j Y r ei x t I
kidda	c_h I t a
kinka	c_h i N_0 k a
kinkar	c_h i N_0 k a r
kinkað	c_h i N_0 k a D
kinkaði	c_h i N_0 k a D I
kinn	c_h I n
kippi	c_h I h p I
kippt	c_h I f t
kippti	c_h I f t I
kipptist	c_h I f t I s t
kipptu	c_h I f t Y
kippur	c_h I h p Y r
kipraði	c_h I: p r a D I
kirkjan	c_h I r_0 c a n
kirkjubæ	c_h I r_0 c Y p ai
kirkjudagur	c_h I r_0 c Y t a G Y r
kirkjugarðinum	c_h I r_0 c Y k a r D I n Y m
kirkjugestir	c_h I r_0 c Y c E s t I r
kirkjugólfið	c_h I r_0 c Y k ou l f I D
kirkjuhvamms	c_h I r_0 c Y k_h v a m s
kirkjukrakkar	c_h I r_0 c Y k_h r a h k a r
kirkjulegrar	c_h I r_0 c Y l E G r a r
kirkjum	c_h I r_0 c Y m
kirkjuna	c_h I r_0 c Y n a
kirkjuprakkarar	c_h I r_0 c Y p r a h k a r a r
kirkjurnar	c_h I r_0 c Y r t n a r
kirkjutengdum	c_h I r_0 c Y t_h ei N t Y m
kirkjutorg	c_h I r_0 c Y t O r k
kirkjuturninn	c_h I r_0 c Y t_h Y r t n I n
kirkjutónlist	c_h I r_0 c Y t_h ou n l I s t
kirkjutúns	c_h I r_0 c Y t_h u n s
kirkjuvegi	c_h I r_0 c Y v ei j I
kirtla	c_h I r_0 t l a
kisa	c_h I: s a
kistan	c_h I s t a n
kistli	c_h I s t l I
kistlinum	c_h I s t l I n Y m
kistu	c_h I s t Y
kistulagninguna	c_h I s t Y l a k n i N k Y n a
kjaft	c_h a f t
kjafti	c_h a f t I
kjaftinum	c_h a f t I n Y m
kjaftur	c_h a f t Y r
kjagaði	c_h a: G a D I
kjalarneshreppi	c_h a: l a r n E s r_0 E h p I
kjalarneslaug	c_h a: l a r n E s t l 9i G
kjallaragluggann	c_h a t l a r a k l Y k a n
kjallaraholu	c_h a t l a r a h O l Y
kjallarann	c_h a t l a r a n
kjallarans	c_h a t l a r a n s
kjallaranum	c_h a t l a r a n Y m
kjallarinn	c_h a t l a r I n
kjamma	c_h a m a
kjammana	c_h a m a n a
kjarakaup	c_h a: r a k_h 9i p
kjaranefnd	c_h a: r a n E m t
kjaranefndar	c_h a: r a n E m t a r
kjarasamninga	c_h a: r a s a m n i N k a
kjarasamningi	c_h a: r a s a m n i J c I
kjarasamnings	c_h a: r a s a m n i N s
kjarnakonur	c_h a r t n a k_h O n Y r
kjarnanum	c_h a r t n a n Y m
kjarnorkukafbáti	c_h a r t n O r_0 k Y k_h a v p au t I
kjarrið	c_h a r I D
kjartani	c_h a r_0 t a n I
kjarvalsstaði	c_h a r v a l s t a D I
kjálkann	c_h au l_0 k a n
kjánalega	c_h au: n a l E G a
kjáni	c_h au: n I
kjóla	c_h ou: l a
kjólana	c_h ou: l a n a
kjósendur	c_h ou: s E n t Y r
kjölinn	c_h 9: l I n
kjörbúðartrú	c_h 9 r p u D a r t_h r u
kjördag	c_h 9 r t a G
kjördæmum	c_h 9 r t ai m Y m
kjörskrá	c_h 9 r_0 s k r au
kjörstað	c_h 9 r_0 s t a D
kjörstjórn	c_h 9 r_0 s t j ou r t n_0
kjörtímabil	c_h 9 r_0 t_h i m a p I l
kjötbollur	c_h 9 t p O l Y r
kjöti	c_h 9: t I
kjúklinga	c_h u h k l i N k a
kjúklingabringa	c_h u h k l i N k a p r i N k a
klassa	k_h l a s a
klaustrið	k_h l 9i s t r I D
klefa	k_h l E: v a
klefann	k_h l E: v a n
klefinn	k_h l E: v I n
kleifarvatn	k_h l ei: v a r v a t n_0
kleinur	k_h l ei: n Y r
klemensdóttir	k_h l E: m E n s t ou h t I r
klemmdur	k_h l E m t Y r
klerkar	k_h l E r_0 k a r
klerks	k_h l E r_0 k s
klerksins	k_h l E r_0 k s I n s
klerkur	k_h l E r_0 k Y r
klettakirkjan	k_h l E h t a c_h I r_0 c a n
klettanna	k_h l E h t a n a
klettar	k_h l E h t a r
klettaskorum	k_h l E h t a s k O r Y m
klettur	k_h l E h t Y r
kleópatra	k_h l E: ou p_h a t r a
klifrað	k_h l I v r a D
klifrið	k_h l I v r I D
klikk	k_h l I h k
klingdi	k_h l i N t I
klippingu	k_h l I h p i N k Y
klippt	k_h l I f t
klipptum	k_h l I f t Y m
klippum	k_h l I h p Y m
klippur	k_h l I h p Y r
klisju	k_h l I: s j Y
klisjuiðnaðurinn	k_h l I: s j Y I D n a D Y r I n
klofa	k_h l O: v a
klofinn	k_h l O: v I n
klofna	k_h l O p n a
klofnum	k_h l O p n Y m
klofnun	k_h l O p n Y n
klukknahreim	k_h l Y h k n a r_0 ei m
klukku	k_h l Y h k Y
klukkuna	k_h l Y h k Y n a
klukkustund	k_h l Y h k Y s t Y n t
klukkutímar	k_h l Y h k Y t_h i m a r
klumpinn	k_h l Y m_0 p I n
klumsa	k_h l Y m s a
klykkti	k_h l I x t I
klámi	k_h l au: m I
klár	k_h l au: r
klárhrossum	k_h l au r_0 O s Y m
klárir	k_h l au: r I r
klárlega	k_h l au r l E G a
klæddir	k_h l ai t I r
klæddu	k_h l ai t Y
klæddust	k_h l ai t Y s t
klín	k_h l i: n
klíðum	k_h l i: D Y m
klók	k_h l ou: k
klókindi	k_h l ou: c I n t I
klórar	k_h l ou: r a r
klóraði	k_h l ou: r a D I
klórflúorkolefni	k_h l ou r_0 f l u O r_0 k_h O l E p n I
klósetti	k_h l ou: s E h t I
klósettin	k_h l ou: s E h t I n
klósettpappír	k_h l ou: s E h t p_h a h p i r
klósettunum	k_h l ou: s E h t O n Y m
klöngrast	k_h l 9i N k r a s t
klúbbar	k_h l u p a r
klúbbastarf	k_h l u p a s t a r f
klúbbhúsi	k_h l u p h u s I
klúbbi	k_h l u p I
klúbbsins	k_h l u p s I n s
klúbbum	k_h l u p Y m
klúbbur	k_h l u p Y r
klúðra	k_h l u D r a
knapar	k_h n a: p a r
knappt	k_h n a f t
knattspyrnusambands	k n a h t s p I r t n Y s a m p a n t s
knöttinn	k_h n 9 h t I n
knötturinn	k_h n 9 h t Y r I n
knúin	k_h n u: I n
knúti	k_h n u: t I
knúts	k_h n u t s
koddamanninum	k_h O t a m a n I n Y m
koddann	k_h O t a n
kofann	k_h O: v a n
kofanna	k_h O: v a n a
koffortið	k_h O f O r_0 t I D
kofunum	k_h O: v O n Y m
koju	k_h Oi j Y
kokið	k_h O: c I D
kokteila	k_h O x t ei l a
kolagrill	k_h O: l a k r I l
kolamola	k_h O: l a m O l a
kolbeinn	k_h O l p ei t n_0
kolbeinsson	k_h O l p ei n s O n
kolefnis	k_h O: l E p n I s
kolfinna	k_h O l f I n a
kollega	k_h O l E k a
kolli	k_h O t l I
kollu	k_h O t l Y
kolsvört	k_h O l s v 9 r_0 t
koltvísýrings	k_h O l t_h v i s i r i N s
kolvetni	k_h O l v E h t n I
kommenta	k_h O m E n t_h a
kommentunum	k_h O m E n_0 t O n Y m
kommóðu	k_h O m ou D Y
kommóðunni	k_h O m ou D Y n I
kommúnismans	k_h O m u n I s m a n s
kommúnismi	k_h O m u n I s m I
kommúnistaflokksins	k_h O m u n I s t a f l O h k s I n s
kommúnistar	k_h O m u n I s t a r
kompan	k_h O m_0 p a n
kompaní	k_h O m_0 p a n i
kompaníi	k_h O m_0 p a n i I
komplíss	k_h O m p_h l i s
kompu	k_h O m_0 p Y
konung	k_h O: n u N k
konungar	k_h O: n u N k a r
konunginn	k_h O: n u J c I n
konunginum	k_h O: n u J c I n Y m
konunglega	k_h O: n u N k l E G a
konungsfjölskyldunnar	k_h O: n u N s f j 9 l s c I l t Y n a r
konungshöllin	k_h O: n u N s h 9 t l I n
konungurinn	k_h O: n u N k Y r I n
koppur	k_h O h p Y r
korkana	k_h O r_0 k a n a
korpu	k_h O r_0 p Y
korpúlfsstöðum	k O r_0 p u f l s t 9 D Y m
kortakerfinu	k_h O r_0 t a c_h E r v I n Y
kortalesara	k_h O r_0 t a l E s a r a
kortsins	k_h O r_0 t s I n s
kosningabaráttu	k_h O s t n i N k a p a r au h t Y
kosningarrétt	k_h O s t n i N k a r j E h t
kosningu	k_h O s t n i N k Y
kosningunum	k_h O s t n i N k O n Y m
kosnir	k_h O s t n I r
kossa	k_h O s a
kossar	k_h O s a r
kossum	k_h O s Y m
kostnaðarhækkanir	k_h O s t n a D a r_0 h ai h k a n I r
kostnaðarsamrar	k_h O s t n a D a r_0 s a m r a r
kostnaðinn	k_h O s t n a D I n
kostnaðurinn	k_h O s t n a D Y r I n
krabba	k_h r a p a
krabbadýr	k_h r a p a t i r
krabbamein	k_h r a p a m ei n
krabbameina	k_h r a p a m ei n a
krabbameini	k_h r a p a m ei n I
krabbameinið	k_h r a p a m ei n I D
krabbameins	k_h r a p a m ei n s
krabbameinsfélagið	k_h r a p a m ei n s f j E l ai j I D
krabbameinsfélags	k_h r a p a m ei n s f j E l a x s
krabbameinsráðgjafarinnar	k_h r a p a m ei n s r au D c a v a r I n a r
krabbameinssjúklinga	k_h r a p a m ei n s j u h k l i N k a
krafinn	k_h r a: v I n
krafist	k_h r a: v I s t
kraft	k_h r a f t
krafta	k_h r a f t a
kraftmikilli	k_h r a f t m I c I t l I
krakkana	k_h r a h k a n a
krakkarnir	k_h r a h k a r t n I r
krakki	k_h r a h c I
kramið	k_h r a: m I D
krampa	k_h r a m_0 p a
krampana	k_h r a m_0 p a n a
kreddum	k_h r E t Y m
krefjist	k_h r E v j I s t
kreppt	k_h r E f t
krepptar	k_h r E f t a r
kreppti	k_h r E f t I
krepptir	k_h r E f t I r
krepptist	k_h r E f t I s t
krimmi	k_h r I m I
kringla	k_h r i N l a
kringlan	k_h r i N l a n
kringlu	k_h r i N l Y
kringlubíó	k_h r i N l Y p i j ou
kringlukráin	k_h r i N l Y k_h r au I n
kringlumýrarbrautar	k_h r i N l Y m i r a r p r 9i t a r
kringlunnar	k_h r i N l Y n a r
kringlunni	k_h r i N l Y n I
kringlur	k_h r i N l Y r
kringlusafn	k_h r i N l Y s a p n_0
kringlusafni	k_h r i N l Y s a p n I
kringlótta	k_h r i N l ou h t a
kristalshöndlarinn	k_h r I s t a l s h 9 n t l a r I n
kristinssonar	k_h r I s t I n s O n a r
kristjánsborg	k_h r I s t j au n s p O r k
kristnihátíð	k_h r I s t n I h au t_h i D
kristnir	k_h r I s t n I r
kristnu	k_h r I s t n Y
kristnum	k_h r I s t n Y m
kristný	k_h r I s t n i
krists	k_h r I s t s
kristshöfn	k_h r I s t s h 9 p n
kristskirkja	k_h r I s t s c_h I r_0 c a
kristskirkjan	k_h r I s t s c_h I r_0 c a n
kristskirkju	k_h r I s t s c_h I r_0 c Y
kristófersson	k_h r I s t ou f E r_0 s O n
kroppa	k_h r O h p a
kroppnum	k_h r O h p n Y m
kross	k_h r O s
krossfarararnir	k_h r O s f a r a r a r t n I r
krossferð	k_h r O s f E r D
krosshúsið	k_h r O s h u s I D
krosslagðar	k_h r O s t l a G D a r
krossleggur	k_h r O s t l E k Y r
krotað	k_h r O: t a D
krufningarsýnum	k_h r Y p n i N k a r_0 s i n Y m
krukka	k_h r Y h k a
krukku	k_h r Y h k Y
krukkunnar	k_h r Y h k Y n a r
krummi	k_h r Y m I
krumpað	k_h r Y m_0 p a D
krumpaða	k_h r Y m_0 p a D a
krumpaðan	k_h r Y m_0 p a D a n
krumpuð	k_h r Y m_0 p Y D
krumpuðum	k_h r Y m_0 p Y D Y m
krumshólum	k_h r Y m s h ou l Y m
krunk	k_h r u N_0 k
krunkaði	k_h r u N_0 k a D I
krunki	k_h r u J_0 c I
krupu	k_h r Y: p Y
kruss	k_h r Y s
kryddað	k_h r I t a D
kryddblöndu	k_h r I t p l 9 n t Y
kryddið	k_h r I t I D
kryddjurtir	k_h r I t j Y r_0 t I r
kryddmix	k_h r I t m I k s
kryppu	k_h r I h p Y
kránni	k_h r au n I
kræsingum	k_h r ai: s i N k Y m
krítarkortum	k_h r i: t a r_0 k_h O r_0 t Y m
krónni	k_h r ou n I
krónosar	k_h r ou: n O s a r
krónum	k_h r ou: n Y m
kröfuganga	k_h r 9: v Y k au N k a
kröfugerðir	k_h r 9: v Y c E r D I r
kröfulýsingu	k_h r 9: v Y l i s i N k Y
kröfur	k_h r 9: v Y r
krökk	k_h r 9 h k
krökkunum	k_h r 9 h k O n Y m
kröppu	k_h r 9 h p Y
kubbasett	k_h Y p a s E h t
kubbasettið	k_h Y p a s E h t I D
kunn	k_h Y n
kunnugir	k_h Y n Yi j I r
kunnuglegan	k_h Y n Y l E G a n
kunnuglegum	k_h Y n Y G l E G Y m
kvaddur	k_h v a t Y r
kvalið	k_h v a: l I D
kvartmíluklúbbsins	k_h v a r_0 t m i l Y k_h l u p s I n s
kvatt	k_h v a h t
kvefinu	k_h v E: v I n Y
kveldi	k_h v E l t I
kveldúlf	k_h v E l t u l f
kveldúlfs	k_h v E l t u l f s
kvelur	k_h v E: l Y r
kvenfélag	k_h v E n f j E l a G
kvenfólk	k_h v E n f ou l_0 k
kvenfólkið	k_h v E n f ou l_0 c I D
kvenhormónum	k_h v E n h O r m ou n Y m
kvenkyn	k_h v E n c_h I n
kvenkynið	k_h v E: n c_h I n I D
kvenkynsnafnorð	k_h v E J c_h I n s t n a p n O r D
kvenlegur	k_h v E n l E G Y r
kvennadagurinn	k_h v E n a t a G Y r I n
kvennaflokki	k_h v E n a f l O h c I
kvenréttindadeginum	k_h v E n r j E h t I n t a t ei j I n Y m
kverkar	k_h v E r_0 k a r
kverkfjöll	k_h v E r_0 k f j 9 t l_0
kveðin	k_h v E: D I n
kveðið	k_h v E: D I D
kveðst	k_h v E D s t
kvikmyndahátíðinni	k_h v I k m I n t a h au t_h i D I n I
kvikmyndanna	k_h v I k m I n t a n a
kvikmyndasjóði	k_h v I: k m I n t a s j ou D I
kvikmyndasjóðs	k_h v I: k m I n t a s j ou D s
kvikmyndasögunnar	k_h v I k m I n t a s 9 G Y n a r
kvikmyndum	k_h v I k m I n t Y m
kvikna	k_h v I h k n a
kviknakin	k_h v I k n a c I n
kvintett	k_h v I n_0 t E h t
kvittaði	k_h v I h t a D I
kviðinn	k_h v I: D I n
kviður	k_h v I: D Y r
kvöldlagi	k_h v 9 l t l ai j I
kvöldmatinn	k_h v 9 l t m a t I n
kvöldmáltíðin	k_h v 9 l t m au l_0 t_h i D I n
kvölds	k_h v 9 l s
kylfulengdir	c_h I l v Y l ei N t I r
kynbótanefnd	c_h I: n p ou t a n E m t
kynferðislegs	c_h I n f E r D I s t l E x s
kynferðislegt	c_h I n f E r D I s t l E x t
kyngdi	c_h i N t I
kyngi	c_h i J c I
kyngja	c_h i J c a
kynlífsiðnaðurinn	c_h I n l i f s I D n a D Y r I n
kynlífsþjónustu	c_h I n l i f s T j ou n Y s t Y
kynningarbæklingi	c_h I n i N k a r p ai h k l i J c I
kynningarfulltrúa	c_h I n i N k a r f Y l_0 t_h r u a
kynningarfundur	c_h I n i N k a r f Y n t Y r
kynningarmyndir	c_h I n i N k a r m I n t I r
kynntu	c_h I n_0 t Y
kynþætti	c_h I n T ai h t I
kyrfilega	c_h I r v I l E G a
kyrkt	c_h I r_0 t
kyrra	c_h I r a
kyrrahafinu	c_h I r a h a v I n Y
kyrran	c_h I r a n
kyrrar	c_h I r a r
kyrrstöðuvinna	c_h I r s t 9 D Y v I n a
kyrrt	c_h I r_0 t
kyrru	c_h I r Y
kyrrðarstund	c_h I r D a r_0 s t Y n t
káfa	k_h au: v a
kálfinum	k_h au l v I n Y m
kápuhnöppunum	k_h au: p Y n_0 9 h p O n Y m
kápunni	k_h au: p Y n I
kárahnjúkavirkjunar	k_h au: r a n_0 j u k a v I r_0 c Y n a r
kársnesi	k_h au r_0 s n E s I
kársness	k_h au r_0 s t n E s
kærastinn	c_h ai: r a s t I n
kærunefndar	c_h ai: r Y n E m t a r
kíki	c_h i: c I
kíkti	c_h i x t I
kíló	c_h i: l ou
kíminn	c_h i: m I n
kínverskir	c_h i n v E r_0 s c I r
kínverskra	c_h i n v E r_0 s k r a
kínversku	c_h i n v E r_0 s k Y
kíóið	c_h i: ou I D
kófið	k_h ou: v I D
kóngur	k_h ou N k Y r
kópaskeri	k_h ou: p a s c E r I
kóranna	k_h ou: r a n a
kórdrengjum	k_h ou r t r ei J c Y m
kórdrengur	k_h ou r t r ei N k Y r
kórstjóri	k_h ou r_0 s t j ou r I
kóræfing	k_h ou: r ai v i N k
köggullinn	k_h 9 k Y t l I n
kökudunkinn	k_h 9: k Y t u J_0 c I n
kökunni	k_h 9: k Y n I
köngulóarvefurinn	k_h 9i N k Y l ou a r v E v Y r I n
köngurlóarvefur	k_h 9i N k Y r l ou a r v E v Y r
könnuninni	k_h 9 n Y n I n I
kössunum	k_h 9 s O n Y m
köttinn	k_h 9 h t I n
kúgast	k_h u: G a s t
kúnninn	k_h u n I n
kútnum	k_h u h t n Y m
kútveltist	k_h u: t v E l_0 t I s t
labb	l a p
labba	l a p a
labbandi	l a p a n t I
labbað	l a p a D
labbitúr	l a p I t_h u r
lagalegu	l a: G a l E G Y
lagaprófessor	l a: G a p_h r ou f E s O r
lagarfljóti	l a: G a r f l j ou t I
lagg	l a k
laginn	l ai j I n
lagt	l a x t
lakk	l a h k
lakkið	l a h c I D
lakkmyndir	l a h k m I n t I r
lambsull	l a m p s Y t l
lampann	l a m_0 p a n
lampinn	l a m_0 p I n
landbúnaðarráðherra	l a n t p u n a D a r au D h E r a
landbúnaðarstofnunin	l a n t p u n a D a r s t O p n Y n I n
landbúnaðartækni	l a n t p u n a D a r_0 t_h ai h k n I
landlæknir	l a n t l ai h k n I r
landsbanka	l a n t s p au N_0 k a
landsbankann	l a n t s p au N_0 k a n
landsbankanum	l a n t s p au N_0 k a n Y m
landsbanki	l a n t s p au J_0 c I
landsbréf	l a n t s p r j E f
landsbyggð	l a n t s p I G D
landsbyggðarinnar	l a n t s p I G D a r I n a r
landsbókasafn	l a n t s p ou k a s a p n_0
landsbókasafni	l a n t s p ou k a s a p n I
landsfjórðungum	l a n t s f j ou r D u N k Y m
landsframleiðslu	l a n t s f r a m l ei D s t l Y
landslagsmyndir	l a n t s t l a x s m I n t I r
landsliðshópinn	l a n t s t l I D s h ou p I n
landsliðsmanninn	l a n t s t l I D s m a n I n
landssamtökin	l a n t s a m t_h 9 c I n
landsvirkjunar	l a n t s v I r_0 c Y n a r
landverndar	l a n t v E r n t a r
langa	l au N k a
langadal	l au N k a t a l
langafa	l au N k a v a
langafi	l au N k a v I
langasjó	l au N k a s j ou
langdregin	l au N t r ei j I n
langdregið	l au N t r ei j I D
langdvölum	l au N t v 9 l Y m
langholtskirkja	l au N k h O l_0 t s c_h I r_0 c a
langisjór	l au J c I s j ou r
langsamlega	l au N k s a m l E G a
langsokkur	l au N s O h k Y r
langstærsti	l au N k s t ai r_0 s t I
langstökki	l au N k s t 9 h c I
langstökkinu	l au N s t 9 h c I n Y
langsótt	l au N k s ou h t
langtum	l au N_0 t Y m
langtíma	l au N k t_h i m a
langtímaáhrif	l au N t_h i m a au r_0 I f
langyngst	l au J c i N s t
lapplander	l a h p l a n t E r
latneskt	l a h t n E s t
laufferjum	l 9i f E r j Y m
laufásveg	l 9i: v au s v E G
laugardags	l 9i: G a r t a x s
laugardagskvöldið	l 9i: G a r t a x s k_h v 9 l t I D
laugardagslíf	l 9i: G a r t a x s t l i v
laugardagsmorgni	l 9i: G a r t a x s m O r t n I
laugardagsmorgnum	l 9i: G a r t a x s m O r t n Y m
laugardagsmorgun	l 9i: G a r t a x s m O r k Y n
laugardalslaugin	l 9i: G a r t a l s t l 9i j I n
laugardeginum	l 9i: G a r t ei j I n Y m
laugarnesskóla	l 9i: G a r n E s k ou l a
laugarnestanga	l 9i: G a r n E s t_h au N k a
laugarnesvegi	l 9i G a r n E s v ei j I
laugarvatn	l 9i: G a r v a t n_0
laugarásvegi	l 9i: G a r au s v ei j I
laugavegi	l 9i: G a v ei j I
laugaveginum	l 9i: G a v ei j I n Y m
laugin	l 9i: j I n
laugina	l 9i j I n a
lauginni	l 9i j I n I
launahækkana	l 9i: n a h ai h k a n a
launahækkanir	l 9i: n a h ai h k a n I r
launanefndar	l 9i: n a n E m t a r
launkofa	l 9i N k_h O v a
lausn	l 9i s t n_0
lausna	l 9i s t n a
lausnina	l 9i s t n I n a
lausnum	l 9i s t n Y m
leggangaopið	l E G k au N k a O p I D
leggina	l E c I n a
leggst	l E k s t
leggöngin	l E G 9i J c I n
leginum	l ei j I n Y m
legu	l E: G Y
leiddi	l ei t I
leiddist	l ei t I s t
leiddumst	l ei t Y m s t
leiddur	l ei t Y r
leifssyni	l ei f s I n I
leigubifreiðarstjóra	l ei: G Y p I v r ei D a r s t j ou r a
leiguflugi	l ei: G Y f l Yi j I
leikanna	l ei: k a n a
leikfélagið	l ei k f j E l ai j I D
leikkafli	l ei: k_h a p l I
leikkona	l ei k O n a
leikkonuna	l ei: k_h O n Y n a
leikkonunnar	l ei k_h O n Y n a r
leikmannahópnum	l ei k m a n a h ou h p n Y m
leikmunageymslu	l ei k m Y n a c ei m s t l Y
leiknir	l ei h k n I r
leikritasafn	l ei: k r I t a s a p n_0
leikriti	l ei: k r I t I
leikritinu	l ei: k r I t I n Y
leikritið	l ei: k r I t I D
leikstýrt	l ei k s t i r_0 t
leiksýningu	l ei: k s i n i N k Y
leiktu	l ei x t Y
leikvelli	l ei: k v E t l I
leirklessa	l ei: r k_h l E s a
leirpyttir	l ei r p_h I h t I r
leirtau	l ei r_0 t_h 9i
leiðangurinn	l ei: D au N k Y r I n
leiðarsteinninn	l ei: D a r_0 s t ei t n I n
leiðbeiningarreglum	l ei D p ei n i N k a r E k l Y m
leiðigjarnt	l ei: D I c a n_0 t
leiðinlegt	l ei: D I n l E x t
leiðréttingu	l ei D r j E h t i N k Y
lengd	l ei N t
lengdar	l ei N t a r
lengdinni	l ei N t I n I
lengdist	l ei N t I s t
lengdust	l ei N t Y s t
lengi	l ei J c I
lengir	l ei J c I r
lengstra	l ei N s t r a
lengstu	l ei N s t Y
lengstum	l ei N s t Y m
lengt	l ei N_0 t
lerki	l E r_0 c I
lesna	l E s t n a
letrið	l E: t r I D
leyndarskráningu	l ei n t a r_0 s k r au n i N k Y
leynilegt	l ei: n I l E x t
leynilögreglustjórans	l ei: n I l 9 G r E k l Y s t j ou r a n s
leðurhúfan	l E: D Y r h u v a n
leðurpakki	l E: D Y r p_h a h c I
leðursófa	l E: D Y r s ou f a
leósdóttir	l E: ou s t ou h t I r
lifir	l I: v I r
lifna	l I p n a
liggi	l I c I
liggjandi	l I c a n t I
liggjum	l I c Y m
limmuna	l I m Y n a
lindasókn	l I n t a s ou h k n
lindubuff	l I n t Y p Y f
linka	l i N_0 k a
linkind	l i n c_h I n t
linnulaust	l I n Y l 9i s t
lippu	l I h p Y
listafólki	l I s t a f ou l_0 c I
listanna	l I s t a n a
listasafnsins	l I s t a s a p n_0 s I n s
listaverkum	l I s t a v E r_0 k Y m
listnám	l I s t n au m
listrænn	l I s t r ai t n_0
listrænni	l I s t r ai t n I
listsköpun	l I s t s k 9 p Y n
listsköpunar	l I s t s k 9 p Y n a r
litar	l I: t a r
litarmerkingu	l I: t a r m E r_0 c i N k Y
litasamsetningin	l I: t a s a m s E h t n i J c I n
litlar	l I h t l a r
litlubrú	l I h t l Y p r u
litlum	l I h t l Y m
litríkastir	l I: t r i k a s t I r
litríkum	l I: t r i k Y m
litrófs	l I: t r ou f s
liðagigt	l I: D a c I x t
liðka	l I T k a
liðsmönnum	l I D s m 9 n Y m
liðugir	l I: D Yi j I r
ljósaskiptunum	l j ou: s a s c I f t O n Y m
ljósmyndasafns	l j ou s m I n t a s a p n_0 s
ljósrauðu	l j ou: s r 9i D Y
ljósrauðum	l j ou: s r 9i D Y m
ljósritunarvélar	l j ou: s r I t Y n a r v j E l a r
ljósvallagötunni	l j ou: s v a t l a G 9 t Y n I
ljósviti	l j ou: s v I t I
ljúffengar	l j u f ei N k a r
ljúfur	l j u: v Y r
ljúktu	l j u x t Y
lofsamlega	l O f s a m l E G a
loftfirrðrar	l O f t f I r D r a r
loftflæðiuppsetningar	l O f t f l ai D I Y h p s E h t n I N k a r
lofthjúpnum	l O f t C u h p n Y m
loftleki	l O f t l E c I
loftljósið	l O f t l j ou s I D
loftmengun	l O f t m ei N k Y n
loftsal	l O f t s a l
loftsalurinn	l O f t s a l Y r I n
loftsdóttir	l O f t s t ou h t I r
loftsins	l O f t s I n s
loftskipti	l O f t s c I f t I
loftslag	l O f t s t l a G
loftslagi	l O f t s t l ai j I
loftslagsbreytingar	l O f t s t l a x s p r ei t i N k a r
loftslagsins	l O f t s t l a x s I n s
lokaskýrslum	l O: k a s c i r_0 s t l Y m
lokaþáttur	l O: k a T au h t Y r
lokunni	l O: k Y n I
losni	l O s t n I
lubba	l Y p a
lubbann	l Y p a n
lukkunnar	l Y h k Y n a r
lummur	l Y m Y r
lungna	l u N n a
lungnasjúkdóma	l u N n a s j u k t ou m a
lungnasjúklinga	l u N n a s j u h k l i N k a
lungnaígræðslu	l u N n a i k r ai D s t l Y
lungum	l u N k Y m
lungunum	l u N k O n Y m
lyfjafræðingur	l I v j a f r ai D i N k Y r
lyfjagras	l I v j a k r a s
lyfjapróf	l I v j a p_h r ou v
lyfjarannsóknir	l I v j a r a n s ou h k n I r
lyfjaverslun	l I v j a v E r_0 s t l Y n
lyfjaverslunar	l I v j a v E r_0 s t l Y n a r
lyftistöng	l I f t I s t 9i N k
lygndi	l i N t I
lygnt	l i N t
lykilhlutverk	l I: c I l l_0 Y t v E r_0 k
lykilhlutverki	l I: c I l l_0 Y t v E r_0 c I
lykt	l I x t
lykta	l I x t a
lyktar	l I x t a r
lyktuðu	l I x t Y D Y
lyng	l i N k
lyngbak	l i N k p a k
lynghæna	l i N k h ai n a
lyngi	l i J c I
lyngið	l i J c I D
lyngási	l i N k au s I
lyngþúfur	l i n k T u v Y r
lágafellsskóla	l au: G a f E l s k ou l a
lágmarks	l au G m a r_0 k s
lánasjóðs	l au: n a s j ou D s
lántöku	l au n t_h 9 k Y
látlaus	l au t l 9i s
látlausar	l au t l 9i s a r
látlausum	l au: t l 9i s Y m
láttu	l au h t Y
lækjarbotnum	l ai: c a r_0 p O h t n Y m
lækjargötu	l ai: c a r k 9 t Y
lækjarskóla	l ai: c a r_0 s k ou l a
lækkaðir	l ai h k a D I r
lækkun	l ai h k Y n
læknafélagsins	l ai h k n a f j E l a x s I n s
læknana	l ai h k n a n a
læknastofunni	l ai h k n a s t O v Y n I
læknavakt	l ai h k n a v a x t
læknavaktin	l ai h k n a v a x t I n
læknirinn	l ai h k n I r I n
læknishendur	l ai h k n I s h E n t Y r
læknisskoðun	l ai h k n I s k O D Y n
læknisvottorð	l ai h k n I s v O h t O r D
lærisveina	l ai: r I s v ei n a
lærisveinar	l ai: r I s v ei n a r
lærisveinn	l ai: r I s v ei t n_0
læsta	l ai s t a
lélegri	l j E: l E G r I
léttirinn	l j E h t I r I n
lífeyrisréttinda	l i: v ei r I s r j E h t I n t a
lífeyrisréttindi	l i: v ei r I s r j E h t I n t I
lífeyrissjóðs	l i: v ei r I s j ou D s
lífeyrissjóðum	l i: v ei r I s j ou D Y m
líffræðingur	l i f r ai D i N k Y r
líffæri	l i f ai r I
líffærum	l i f ai r Y m
lífrænni	l i v r ai t n I
lífshættu	l i f s h ai h t Y
lífsleikni	l i f s t l ei h k n I
lífsnauðsyn	l i f s t n 9i D s I n
lífsorku	l i f s O r_0 k Y
lífsreynslu	l i f s r ei n s t l Y
lífsskoðun	l i f s k O D Y n
lífsspeki	l i f s p E c I
lífstykki	l i f s t I h c I
lífsþorsta	l i f s T O r_0 s t a
líkamsrækt	l i: k a m s r ai x t
líkamsræktarstöðvar	l i: k a m s r ai x t a r_0 s t 9 D v a r
líkingu	l i: c i N k Y
líkkistunni	l i: c I s t Y n I
líklegir	l i k l ei j I r
líknandi	l i h k n a n t I
líknarmála	l i h k n a r m au l a
lófa	l ou: v a
lófafylli	l ou: v a f I t l I
lófana	l ou: v a n a
lófanum	l ou: v a n Y m
lófunum	l ou: v O n Y m
lóuverksmiðjunni	l ou: Y v E r_0 k s m I D j Y n I
lögfræðingnum	l 9 x f r ai D i N n Y m
lögga	l 9 k a
löggildingarstofu	l 9 G c I l t i N k a r_0 s t O v Y
löggæsla	l 9 G c ai s t l a
löggæslan	l 9 G c ai s t l a n
löglegt	l 9 G l E x t
lögregluforingja	l 9 G r E k l Y f O r i J c a
lögreglufulltrúinn	l 9 G r E k l Y f Y t l_0 t_h r u I n
lögregluhernum	l 9 G r E k l Y h E r t n Y m
lögreglumála	l 9 G r E k l Y m au l a
löng	l 9i: N k
löngum	l 9i N k Y m
löngun	l 9i N k Y n
lönguninni	l 9i N k Y n I n I
löngusker	l 9i N k Y s c E r
löngutöng	l 9i N k Y t_h 9i N k
lýsingin	l i: s i J c I n
maddaman	m a t a m a n
magga	m a k a
magister	m a k I s t E r
magnarinn	m a k n a r I n
magnskrá	m a k n_0 s k r au
makaskiptum	m a: k a s c I f t Y m
makka	m a h k a
malarslitlag	m a: l a r s t l I t l a G
mamman	m a m a n
manngeng	m a n c ei N k
manngreinarálit	m a n k r ei n a r au l I t
mannkindinni	m a J c_h I n t I n I
mannkyn	m a n c_h I n
mannkynið	m a J c_h I n I D
mannlífs	m a n l i f s
mannmargt	m a n m a r_0 t
mannmergð	m a n m E r D
mannréttindasamtaka	m a n r j E h t I n t a s a m t_h a k a
mannvernd	m a n v E r n t
mannvirkjanefnd	m a n v I r_0 c a n E m t
mannþekkjari	m a n T E h c a r I
marflatt	m a r_0 f l a h t
margmiðlunarskólann	m a r k m I D l Y n a r_0 s k ou l a n
margmiðlunartæknin	m a r k m I D l Y n a r_0 t_h ai h k n I n
margnota	m a r k n O t a
margs	m a r k s
margsinnis	m a r k s I n I s
margslungnum	m a r k s t l u N n Y m
margstofna	m a r k s t O p n a
margt	m a r_0 t
markaskorara	m a r_0 k a s k O r a r a
markaskorari	m a r_0 k a s k O r a r I
markaðarins	m a r_0 k a D a r I n s
markaðssetningar	m a r_0 k a D s E h t n I N k a r
marki	m a r_0 c I
markmiðin	m a r_0 k m I D I n
markmiðskenningar	m a r_0 k m I D s c_h E n i N k a r
marks	m a r_0 k s
marksins	m a r_0 k s I n s
markvissan	m a r_0 k v I s a n
marðarskinnshúfu	m a r D a r_0 s c I n s h u v Y
masterkard	m a s t E r k_h a r t
matföng	m a t f 9i N k
matreiðslumeistari	m a: t r ei D s t l Y m ei s t a r I
matslistum	m a: t s t l I s t Y m
matsskýrslunni	m a: t s c i r_0 s t l Y n I
matvæladagur	m a: t v ai l a t a G Y r
maísplöntunnar	m ai: s p_h l 9 n_0 t Y n a r
megi	m ei j I
megindráttum	m ei j I n t r au h t Y m
megingíganna	m ei j I n c i G a n a
meginhluti	m ei j I n l_0 Y t I
meginlandi	m ei j I n l a n t I
meginlandsmisgengið	m ei j I n l a n t s m I s c ei J c I D
meginmáli	m ei j I n m au l I
meginskuldbinding	m ei j I n s k Y l t p I n t i N k
meginverkefni	m ei j I n v E r_0 c E p n I
meginástæða	m ei: j I n au s t ai D a
meiddist	m ei t I s t
meinvarp	m ei n v a r_0 p
meistaraprófi	m ei s t a r a p_h r ou v I
mekki	m E h c I
melkorku	m E l k_h O r_0 k Y
melkorkusvip	m E l k_h O r_0 k Y s v I p
meltinguna	m E l_0 t i N k Y n a
menningarborgum	m E n i N k a r p O r k Y m
menningarlegt	m E n i N k a r l E x t
menningarmálanefnd	m E n i N k a r m au l a n E m t
menningarsögu	m E n i N k a r_0 s 9 G Y
menningarumræða	m E n i N k a r Y m r ai D a
menningarupplifun	m E n i N k a r Y h p l I v Y n
menningu	m E n i N k Y
menntakerfinu	m E n_0 t a c_h E r v I n Y
menntamálaráðuneytinu	m E n_0 t a m au l a r au D Y n ei t I n Y
menntunarstig	m E n_0 t Y n a r_0 s t I G
merkilegan	m E r_0 c I l E G a n
merkilegt	m E r_0 c I l E x t
merkingarlaust	m E r_0 c i N k a r l 9i s t
merkja	m E r_0 c a
merktar	m E r_0 t a r
merkti	m E r_0 t I
merktu	m E r_0 t Y
merktum	m E r_0 t Y m
merktur	m E r_0 t Y r
mestallt	m E s t a l_0 t
metraleitar	m E: t r a l ei t a r
meynni	m ei n I
meðalframleiðsla	m E: D a l f r a m l ei D s t l a
meðalsteikt	m E: D a l s t ei x t
meðfæddri	m E D f ai t r I
mikkelína	m I h c E l i n a
mikki	m I h c I
millibankamarkaði	m I t l I p au N_0 k a m a r_0 k a D I
millibygging	m I t l I p I c i N k
milligöngu	m I t l I k 9i N k Y
minjasafnsins	m I n j a s a p n_0 s I n s
minnibolta	m I n I p O l_0 t a
minningarplagg	m I n i N k a r_0 p_h l a k
minninguna	m I n i N k Y n a
minniskompuna	m I n I s k O m_0 p Y n a
minnisvarði	m I n I s v a r D I
misdjúpt	m I s t j u f t
misheppnuð	m I s h E h p n Y D
misheppnuðu	m I s h E h p n Y D Y
misjafn	m I: s j a p n_0
misjafna	m I: s j a p n a
misjafnar	m I: s j a p n a r
misjafnlega	m I: s j a p l E G a
misjafnt	m I: s j a m_0 t
misjöfn	m I: s j 9 p n_0
misjöfnu	m I: s j 9 p n Y
misjöfnum	m I: s j 9 p n Y m
misvel	m I: s v E l
misþyrmt	m I: s T I r_0 m t
miðaldrakreppu	m I: D a l t r a k_h r E h p Y
miðkjúkur	m I D c_h u k Y r
miðlungsökumaður	m I D l u N s 9 k Y m a D Y r
miðlungsþurrt	m I D l u N s T Y r_0 t
miðvikudagsmorgna	m I D v I k Y t a x s m O r t n a
miðvikudegi	m I D v I k Y t ei j I
mjóhrygginn	m j ou r_0 I c I n
mjólkur	m j ou l_0 k Y r
mjólkurflösku	m j ou l_0 k Y r f l 9 s k Y
mjólkurkaffi	m j ou l_0 k Y r k_h a f I
moggabúðin	m O k a p u D I n
mogginn	m O c I n
morgna	m O r t n a
morgnar	m O r t n a r
morgnaði	m O r t n a D I
morgunkaffi	m O r k u n k_h a f I
morgunkaffið	m O r k u n k_h a f I D
morgunsjónvarp	m O r k Y n s j ou n v a r_0 p
morgunskýrslunni	m O r k Y n s c i r_0 s t l Y n I
morgunsöngur	m O r k Y n s 9i N k Y r
morguntíð	m O r k Y n t_h i D
morguntónar	m O r k Y n t_h ou n a r
morgunvöktum	m O r k Y n v 9 x t Y m
mosfellsbæjar	m O s f E l s p ai j a r
mosfellshrepps	m O s f E l s r_0 E h p s
mosfellskirkju	m O: s f E l s c_h I r_0 c Y
moskusrottum	m O s k Y s r O h t Y m
moðkassann	m O D k_h a s a n
munkar	m u N_0 k a r
munkinum	m u J_0 c I n Y m
munkum	m u N_0 k Y m
munkunum	m u N_0 k O n Y m
munnvatnskúlum	m Y n v a s k u l Y m
musterisriddarinn	m Y s t E r I s r I t a r I n
myndamöppuna	m I n t a m 9 h p Y n a
myndapörin	m I n t a p_h 9 r I n
myndlistarsýningar	m I n t l I s t a r_0 s i n i N k a r
myndstimpla	m I n t s t I m p_h l a
málaflokknum	m au: l a f l O h k n Y m
málfrelsi	m au l f r E l s I
málfríði	m au l f r i D I
málfríður	m au l f r i D Y r
málrækt	m au l r ai x t
málverksins	m au l v E r_0 k s I n s
málþings	m au l T i N s
mánudeginum	m au: n Y t ei j I n Y m
máttarstólpum	m au h t a r_0 s t ou l_0 p Y m
máttlausa	m au h t l 9i s a
mæddur	m ai t Y r
mælikvarða	m ai: l I k_h v a r D a
mæðrastyrksnefnd	m ai D r a s t I r_0 k s n E m t
mógilsá	m ou: c I l s au
mótmælti	m ou t m ai l_0 t I
mömmu	m 9 m Y
múlasna	m u: l a s t n a
múlasnann	m u: l a s t n a n
múlösnum	m u: l 9 s t n Y m
múrsteinum	m u r_0 s t ei n Y m
mýkri	m i: k r I
nafnskírteinið	n a p n_0 s c i r_0 t ei n I D
nafnspjald	n a p n_0 s p j a l t
nafnspjaldið	n a p n_0 s p j a l t I D
nakti	n a x t I
nankinefni	n a n c_h I n E p n I
nautakjöt	n 9i: t a c_h 9 t
nautakjöti	n 9i: t a c_h 9 t I
nauðsynlegt	n 9i D s I n l E x t
nefnda	n E m t a
nefndan	n E m t a n
nefndarmenn	n E m t a r m E n
nefndarmönnum	n E m t a r m 9 n Y m
nefndaráliti	n E m t a r au l I t I
nefndina	n E m t I n a
nefndinni	n E m t I n I
nefndir	n E m t I r
nefndist	n E m t I s t
nefndum	n E m t Y m
nefnt	n E m_0 t
neglt	n E l_0 t
neinna	n ei t n a
neinnar	n ei t n a r
nemakeppnir	n E: m a c_h E h p n I r
nemendaverndar	n E: m E n t a v E r n t a r
nesja	n E: s j a
netkaffi	n E t k_h a f I
netkaffið	n E t k_h a f I D
netverslun	n E: t v E r_0 s t l Y n
netútgáfu	n E: t u t k au v Y
neyðarathvarfsins	n ei: D a r a t k_h v a r f s I n s
niðdimm	n I D t I m
niðurrif	n I: D Y r I v
niðurskurðar	n I: D Y r_0 s k Y r D a r
niðurstaðan	n I: D Y r_0 s t a D a n
niðurstöðuna	n I: D Y r_0 s t 9 D Y n a
niðurstöðunum	n I: D Y r_0 s t 9 D O n Y m
niðurstöðutölu	n I: D Y r_0 s t 9 D Y t_h 9 l Y
niðursveigt	n I: D Y r_0 s v ei x t
njótum	n j ou: t Y m
nokkurrar	n O h k Y r a r
norræna	n O r ai n a
norrænar	n O r ai n a r
norrænna	n O r ai t n a
norrænni	n O r ai t n I
norræns	n O r ai n s
norrænu	n O r ai n Y
norskan	n O r_0 s k a n
norski	n O r_0 s c I
norskur	n O r_0 s k Y r
norðlendingum	n O r D l E n t i N k Y m
norðlingaholti	n O r D l i N k a h O l_0 t I
norðlingaöldulón	n O r D l i N k a 9 l t Y l ou n
norðlægum	n O r D l ai G Y m
norðurpólhettunni	n O r D Y r_0 p_h ou l h E h t Y n I
norðurskógar	n O r D Y r_0 s k ou a r
nottingham	n O h t i N h a m
nuddtækni	n Y t t_h ai h k n I
nákvæma	n au: k_h v ai m a
nákvæmari	n au: k_h v ai m a r I
nákvæmni	n au: k_h v ai m n I
nákvæmum	n au: k_h v ai m Y m
námsbrautir	n au m s p r 9i t I r
nátengd	n au: t_h ei N t
nátengdur	n au: t_h ei N t Y r
náttlampanum	n au h t l a m_0 p a n Y m
náttúruvernd	n au h t u r Y v E r n t
náttúruverndar	n au h t u r Y v E r n t a r
náttúruverndarráð	n au h t u r Y v E r n t a r au D
náttúruverndarsamtök	n au h t u r Y v E r n t a r_0 s a m t_h 9 k
náungann	n au: u N k a n
náunganum	n au: u N k a n Y m
næstkomandi	n ai s t k O m a n t I
næststærsta	n ai s t s t ai r_0 s t a
næststærsti	n ai s t ai s t I
nóbelsverðlaunin	n ou: p E l s v E r l 9i n I n
nöktu	n 9 x t Y
nýbyggingum	n i: p I c i N k Y m
nýlistasafnsins	n i: l I s t a s a p n_0 s I n s
nýsloppinn	n i: s t l O h p I n
nývaknaður	n i: v a h k n a D Y r
obb	O p
obbann	O p a n
obbinn	O p I n
ofansleglatakttruflana	O: v a n s t l E k l a t_h a x t_h r Y p l a n a
off	O f
offari	O f a r I
offjárfesting	O f j au r_0 f E s t i N k
offramleiðslan	O f r a m l ei D s t l a n
offramleiðslu	O f r a m l ei D s t l Y
offsett	O f s E h t
offylli	O f I t l I
ofnskúffu	O p n_0 s k u f Y
ofnsteiktur	O p n_0 s t ei x t Y r
ofsafengnar	O f s a f ei N n a r
ofsakvíða	O f s a k_h v i D a
ofsalegur	O f s a l E G Y r
ofsóknum	O f s ou h k n Y m
ofsóttur	O f s ou h t Y r
oftsinnis	O f t s I n I s
ofurskjaldbökurnar	O: v Y r_0 s c a l t p 9 k Y r t n a r
ofuráherslu	O: v Y r au h E r_0 s t l Y
opinberri	O: p I n p E r I
opinbert	O: p I n p E r_0 t
opna	O h p n a
opnari	O h p n a r I
opnast	O h p n a s t
opnaði	O h p n a D I
opnaður	O h p n a D Y r
opnu	O h p n Y
opnunar	O h p n Y n a r
opnunarfagnaður	O h p n Y n a r f a k n a D Y r
ormssonar	O r m s O n a r
ormstungu	O r m s t u N k Y
orrahríð	O r a r_0 i D
orðasafnsskrárnar	O r D a s a p n_0 s k r au r t n a r
orðatiltæki	O r D a t_h I l_0 t_h ai c I
orðlaus	O r l 9i s
orðnar	O r t n a r
pabbi	p_h a p I
pakki	p_h a h c I
palestínskum	p_h a: l E s t i n s k Y m
pappabox	p_h a h p a p O k s
pappírsblað	p_h a h p i r_0 s p l a D
pappírsskeri	p_h a h p i r_0 s c E r I
paprikur	p_h a: p r I k Y r
par	p_h a: r
parhús	p_h a r h u s
parketi	p_h a r_0 c E t I
pass	p_h a s
pasturslitlar	p_h a s t Y r_0 s t l I h t l a r
pata	p_h a: t a
pen	p_h E: n
peningalykt	p_h E: n i N k a l I x t
peningalítill	p_h E: n i N k a l i t I t l_0
peningar	p_h E: n i N k a r
peningaskápinn	p_h E: n i N k a s k au p I n
peningaskápnum	p_h E: n i N k a s k au h p n Y m
peningaupphæð	p_h E: n i N k a Y h p h ai D
peningaþvætti	p_h E: n i N k a T v ai h t I
peningi	p_h E: n i J c I
penni	p_h E n I
pennum	p_h E n Y m
pensli	p_h E n s t l I
per	p_h E: r
perla	p_h E r t l a
perlufesti	p_h E r t l Y f E s t I
perlur	p_h E r t l Y r
persóna	p_h E r_0 s ou n a
persónulegum	p_h E r_0 s ou n Y l E G Y m
persónulegur	p_h E r_0 s ou n Y l E G Y r
persónuleikans	p_h E r_0 s ou n Y l ei k a n s
persónuleikaprófið	p_h E r_0 s ou n Y l ei k a p_h r ou v I D
persónuupplýsinga	p_h E r_0 s ou n Y Y h p l i s i N k a
persónuupplýsingar	p_h E r_0 s ou n Y Y h p l I s i N k a r
peru	p_h E: r Y
perum	p_h E: r Y m
peysunni	p_h ei: s Y n I
pilsi	p_h I l s I
pilsum	p_h I l s Y m
piltana	p_h I l_0 t a n a
piltsins	p_h I l_0 t s I n s
piparmey	p_h I: p a r m ei
pirrar	p_h I r a r
pirringi	p_h I r i J c I
plaggið	p_h l a c I D
planinu	p_h l a: n I n Y
planið	p_h l a: n I D
plantað	p_h l a n_0 t a D
plantaði	p_h l a n t_h a D I
plasmíðsins	p_h l a s m i D s I n s
plastdúkur	p_h l a s t u k Y r
plasthnúðunum	p_h l a s t n_0 u D O n Y m
plasti	p_h l a s t I
plastlagningar	p_h l a s t l a k n i N k a r
plastpokar	p_h l a s t p_h O k a r
plastprent	p_h l a s t p_h r E n_0 t
plaststrengur	p_h l a s t r ei N k Y r
plata	p_h l a: t a
platað	p_h l a: t a D
platna	p_h l a h t n a
plokkun	p_h l O h k Y n
plágu	p_h l au: G Y
pláss	p_h l au s
plássinu	p_h l au s I n Y
plássið	p_h l au s I D
plássum	p_h l au s Y m
plássunum	p_h l au s O n Y m
plóginn	p_h l ou j I n
plómutré	p_h l ou: m Y t_h r j E
plön	p_h l 9: n
plöntur	p_h l 9 n_0 t Y r
plötuna	p_h l 9: t Y n a
plötusöfnun	p_h l 9: t Y s 9 p n Y n
popp	p_h O h p
popplag	p_h O h p l a G
popppoki	p_h O h p O c I
popptónlist	p_h O h p t_h ou n l I s t
pottaplöntu	p_h O h t a p_h l 9 n_0 t Y
predikunarstólnum	p_h r E: t I k Y n a r_0 s t ou l n Y m
prestsins	p_h r E s t s I n s
prestslærða	p_h r E s t s t l ai r D a
prófastsdæmisins	p_h r ou: f a s t s t ai m I s I n s
punkta	p_h u n t_h a
punktana	p_h u n_0 t a n a
punktaði	p u n_0 t a D I
purpurarauðri	p_h Y r_0 p Y r a r 9i D r I
páfann	p au: v a n
pálmatré	p_h au l m a t_h r j E
páskaegg	p_h au s k a E k
píanó	p_h i: j a n ou
píanóinu	p_h i: j a n ou I n Y
píanóleikari	p_h i j a n ou l ei k a r I
pílagríma	p_h i: l a k r i m a
pílagrímar	p_h i: l a k r i m a r
pínulitla	p_h i: n Y l I h t l a
pínulitlir	p_h i: n Y l I h t l I r
pínulitlu	p_h i: n Y l I h t l Y
píparann	p_h i: p a r a n
pítsa	p_h i t s a
pókus	p_h ou: k Y s
pólflugi	p_h ou l f l Yi j I
póstkassa	p_h ou s k_h a s a
póstkortum	p_h ou s k_h O r_0 t Y m
póstkössum	p_h ou s t k_h 9 s Y m
póstsamgangna	p_h ou s t s a m k au N n a
póstsins	p_h ou s t s I n s
póststofan	p_h ou s t s t O v a n
rafiðnaðarskólans	r a: v I D n a D a r_0 s k ou l a n s
rafmagnstengingu	r a v m a k n_0 s t_h ei J c i N k Y
rafmagnsveitan	r a v m a k n_0 s v ei t a n
rafmagnsveitu	r a v m a k n_0 s v ei t Y
rafns	r a p n_0 s
rafnsdóttir	r a p n_0 s t ou h t I r
rafnsdóttur	r a p n_0 s t ou h t Y r
rafnssonar	r a p n_0 s O n a r
rafnssyni	r a p n_0 s I n I
rafrænna	r a v r ai t n a
rafrænnar	r a v r ai t n a r
rafrænni	r a v r ai t n I
rafstraum	r a f s t r 9i m
rakt	r a x t
rammasamningur	r a m a s a m n i N k Y r
rammi	r a m I
ranglega	r au N k l E G a
ranglátur	r au N k l au t Y r
rannsókn	r a n s ou h k n
rannsóknardeild	r a n s ou h k n a r t ei l t
rannsóknarnefnd	r a n s ou h k n a r n E m t
rannsóknarskips	r a n s ou h k n a r_0 s c I p s
rapptextar	r a p t E k s t a r
raunneyslu	r 9i n ei s t l Y
rauðka	r 9i T k a
rauðkáli	r 9i D k_h au l I
reffilegur	r E f I l E G Y r
regnskynjara	r E k n_0 s c I n j a r a
regnskúr	r E k n_0 s k u r
reikningsskil	r ei h k n i N s c I l
reikningsskilagúrúar	r ei h k n i N s c I l a k u r u a r
rekkju	r E h c Y
rekstrarnefnd	r E k s t r a r n E m t
rekstrarskilyrði	r E k s t r a r_0 s c I l I r D I
rekstraráætlun	r E k s t r a r au ai h t l Y n
rembdist	r E m t I s t
renglulegur	r ei N l Y l E G Y r
reykholtskirkju	r ei k h O l_0 t s c_h I r_0 c Y
reykjavíkurflugvallar	r ei: c a v i k Y r f l Y G v a t l a r
reykjavíkurflugvelli	r ei: c a v i k Y r f l Y G v E t l I
reykjavíkurflugvöll	r ei: c a v i k Y r f l Y G v 9 t l_0
reykjavíkurflugvöllur	r ei: c a v i k Y r f l Y G v 9 t l Y r
reykjavíkurprófastsdæma	r ei: c a v i k Y r_0 p_h r ou f a s t s t ai m a
riffil	r I f I l
riffillinn	r I f I t l I n
riffla	r I f l a
rifflana	r I f l a n a
rifflar	r I f l a r
rifflinum	r I f l I n Y m
rifflum	r I f l Y m
ringlaða	r i N l a D a
ringluð	r i N l Y D
rjómatoppur	r j ou: m a t_h O h p Y r
rokktónlist	r O h k t_h ou n l I s t
rommi	r O m I
runka	r u N_0 k a
runólfssonar	r Y: n ou l f s O n a r
rykktu	r I x t Y
rásnúmer	r au: s t n u m E r
ráðabruggi	r au: D a p r Y c I
rækjuverksmiðjunni	r ai c Y v E r_0 k s m I D j Y n I
réttarholtsskóla	r j E h t a r_0 h O l_0 t s k ou l a
réttsýnn	r j E h t s i t n
ríkisrekstur	r i: c I s r E k s t Y r
ríkisráð	r i: c I s r au D
ríkisráðið	r i: c I s r au D I D
ríkisstarfsmenn	r i: c I s t a r_0 f s m E n
ríkisútvarpinu	r i: c I s u t v a r_0 p I n Y
ríkisútvarpið	r i: c I s u t v a r_0 p I D
ríkisútvarpsins	r i: c I s u t v a r_0 p s I n s
róbertsdóttur	r ou: p E r_0 t s t ou h t Y r
róbertssyni	r ou: p E r_0 t s I n I
rómantískt	r ou: m a n t_h i s t
rónni	r ou n I
röngum	r 9i N k Y m
rúnna	r u n a
rússneska	r u s t n E s k a
rússneskt	r u s t n E s t
rýriskiptingu	r i: r I s c I f t i N k Y
safnstjóri	s a p n_0 s t j ou r I
sakaruppgjöf	s a: k a r Y h p c 9 v
salts	s a l_0 t s
saltsteinum	s a l_0 t s t ei n Y m
samanherptur	s a: m a n h E r_0 t Y r
samfestingnum	s a m f E s t i N n Y m
samfylgd	s a m f I l t
samfylgdina	s a m f I l t I n a
samgangna	s a m k au N n a
samkeppni	s a m c_h E h p n I
samkeppnin	s a m c_h E h p n I n
samkeppnishamlandi	s a m c_h E h p n I s h a m l a n t I
samkeppnislaga	s a m c_h E h p n I s t l a G a
samkeppnisráð	s a m c_h E h p n I s r au D
samkeppnisráðs	s a m c_h E h p n I s r au D s
samkeppnisstaða	s a m c_h E h p n I s t a D a
samkeppnisstofnunar	s a m c_h E h p n I s t O p n Y n a r
sammerkt	s a m E r_0 t
samnefndri	s a m n E m t r I
samningnum	s a m n i N n Y m
samningsbundinn	s a m n i N s p Y n t I n
samningsupphæðin	s a m n i N s Y h p h ai D I n
samskipta	s a m s c I f t a
samskiptatækni	s a m s c I f t a t_h ai h k n I
samskiptaverkefni	s a m s c I f t a v E r_0 c E p n I
samskiptum	s a m s c I f t Y m
samstarfs	s a m s t a r f s
samstarfsaðili	s a m s t a r f s a D I l I
samstarfshópur	s a m s t a r f s h ou p Y r
samstarfsins	s a m s t a r f s I n s
samstarfslæknar	s a m s t a r f s l ai h k n a r
samstarfsmann	s a m s t a r f s m a n
samstarfsmanni	s a m s t a r f s m a n I
samstarfsmenn	s a m s t a r f s m E n
samstarfsmennirnir	s a m s t a r f s m E n I r t n I r
samstarfsmönnum	s a m s t a r f s m 9 n Y m
samstarfsnefnd	s a m s t a r f s t n E m t
samstarfsnefndar	s a m s t a r f s t n E m t a r
samstarfsnefndarinnar	s a m s t a r f s t n E m t a r I n a r
samstarfsneti	s a m s t a r f s t n E t I
samstarfssamning	s a m s t a r f s a m n i N k
samstarfssamninginn	s a m s t a r f s a m n i J c I n
samstarfsverkefna	s a m s t a r f s v E r_0 c E p n a
samstarfsverkefni	s a m s t a r f s v E r_0 k E p n I
samstarfsvettvangur	s a m s t a r f s v E h t v au N k Y r
samstarfsyfirlýsingar	s a m s t a r f s I v I r l i s i N k a r
samstillt	s a m s t I l_0 t
samtalið	s a: m t_h a l I D
samþykkta	s a m T I x t a
samþykktar	s a m T I x t a r
samþykkti	s a m T I x t I
samþykktinni	s a m T I x t I n I
samþykktir	s a m T I x t I r
samþykktu	s a m T I x t Y
samþykktum	s a m T I x t Y m
sandsteinn	s a n t s t ei t n_0
sandvatns	s a n t v a s
sandvatnshlíð	s a n t v a s l_0 i D
sankti	s a n_0 t I
sautján	s 9i: t j au n
sauðkindar	s 9i D c_h I n t a r
sauðkindin	s 9i D c_h I n t I n
seinn	s ei t n_0
seinna	s ei t n a
seinnameir	s ei t n a m ei r
seinnipartinn	s ei t n I p_h a r_0 t I n
seinniparturinn	s ei t n I p_h a r_0 t Y r I n
september	s E f t E m p E r
sigbjörnsdóttur	s I G p j 9 r_0 s t ou h t Y r
sigbjörnsson	s I G p j 9 r_0 s O n
sigldu	s I l t Y
siglt	s I l_0 t
sigurbergsdóttir	s I: G Y r p E r k s t ou h t I r
sigurbjörnsson	s I: G Y r p j 9 r_0 s O n
sigurbjörnssyni	s I: G Y r p j 9 r_0 s I n I
sigurgestsson	s I: G Y r c E s t s O n
sigursteinn	s I: G Y r_0 s t ei t n_0
silfri	s I l v r I
silfurdoppótt	s I l f Y r t O h p ou h t
silfurskeiðina	s I l f Y r_0 s c ei D I n a
silung	s I: l u N k
silunginn	s I: l u J c I n
silungsveiðivon	s I: l u N s v ei D I v O n
silúngsveiðivon	s I: l u N s v ei D I v O n
sinnaskipti	s I n a s c I f t I
siðspillta	s I D s p I l_0 t a
siðspilltum	s I D s p I l_0 t Y m
sjoppu	s j O h p Y
sjoppuna	s j O h p Y n a
sjálfra	s j au l v r a
sjálfri	s j au l v r I
sjálfrátt	s j au l v r au h t
sjálfráða	s j au l v r au D a
sjálfráður	s j au l v r au D Y r
sjálfræði	s j au l v r ai D I
sjálfs	s j au l f s
sjálfsafgreiðslustöðvum	s j au l f s a v k r ei D s t l Y s t 9 D v Y m
sjálfsafneitun	s j au l v s a v n ei t Y n
sjálfsagða	s j au l f s a G D a
sjálfsagðara	s j au l f s a G D a r a
sjálfsalakaffi	s j au l f s a l a k_h a f I
sjálfsbjargarviðleitnin	s j au l f s p j a r k a r v I D l ei h t n I n
sjálfsdáðum	s j au l s t au D Y m
sjálfsgagnrýni	s j au l f s k a k n_0 r i n I
sjálfshjálparhópur	s j au l f s C au l_0 p a r h ou p Y r
sjálfshjálpin	s j au l f s C au l_0 p I n
sjálfskaparvíti	s j au l f s k a p a r v i t I
sjálfskipt	s j au l f s c I f t
sjálfskiptan	s j au l f s c I f t a n
sjálfskiptingin	s j au l f s c I f t i J c I n
sjálfskiptingu	s j au l f s c I f t i N k Y
sjálfskuldarábyrgð	s j au l f s k Y l t a r au p I r D
sjálfsmark	s j au l f s m a r_0 k
sjálfsmorð	s j au l f s m O r D
sjálfsmorðsárásir	s j au l f s m O r D s au r au s I r
sjálfsmyndinni	s j au l f s m I n t I n I
sjálfstrausts	s j au l f s t_h r 9i s t s
sjálfstæða	s j au l f s t ai D a
sjálfstæðar	s j au l f s t ai D a r
sjálfstæðir	s j au l f s t ai D I r
sjálft	s j au l_0 t
sjálftrekkjandi	s j au l f t_h r E h c a n t I
sjónarsviptir	s j ou: n a r_0 s v I f t I r
sjóndeildarhringnum	s j ou n t ei l t a r_0 i N n Y m
sjónvarpað	s j ou n v a r_0 p a D
sjónvarpi	s j ou n v a r_0 p I
sjónvarpinu	s j ou n v a r_0 p I n Y
sjónvarps	s j ou n v a r_0 p s
sjónvarpsauglýsinga	s j ou n v a r_0 p s 9i G l i s i N k a
sjónvarpsauglýsingar	s j ou n v a r_0 p s 9i G l i s i N k a r
sjónvarpsefni	s j ou n v a r_0 p s E p n I
sjónvarpsfréttir	s j ou n v a r_0 p s f r j E h t I r
sjónvarpshol	s j ou n v a r_0 p s h O l
sjónvarpskort	s j ou n v a r_0 p s k_h O r_0 t
sjónvarpskvöld	s j ou n v a r_0 p s k_h v 9 l t
sjónvarpsmynd	s j ou n v a r_0 p s m I n t
sjónvarpssendingar	s j ou n v a r_0 p s E n t i N k a r
sjónvarpssjúklingur	s j ou n v a r_0 p s j u h k l i N k Y r
sjónvarpsskjáinn	s j ou n v a r_0 p s c au I n
sjónvarpsskjáir	s j ou n v a r_0 p s c au I r
sjónvarpsstöð	s j ou n v a r_0 p s t 9 D
sjónvarpsstöðin	s j ou n v a r_0 p s t 9 D I n
sjónvarpsstöðina	s j ou n v a r_0 p s t 9 D I n a
sjónvarpsstöðva	s j ou n v a r_0 p s t 9 D v a
sjónvarpsstöðvanna	s j ou n v a r_0 p s t 9 D v a n a
sjónvarpsstöðvar	s j ou: n v a r_0 p s t 9 D v a r
sjónvarpsstöðvarinnar	s j ou n v a r_0 p s t 9 D v a r I n a r
sjónvarpsstöðvarnar	s j ou n v a r_0 p s t 9 D v a r t n a r
sjónvarpstæki	s j ou n v a r_0 p s t_h ai c I
sjónvarpstækinu	s j ou n v a r_0 p s t_h ai c I n Y
sjónvarpstækið	s j ou n v a r_0 p s t_h ai c I D
sjónvarpstöðina	s j ou: n v a r_0 p s t 9 D I n a
sjónvarpsviðtali	s j ou n v a r_0 p s v I D t_h a l I
sjónvarpsþátta	s j ou n v a r_0 p s T au h t a
sjónvarpsþáttum	s j ou n v a r_0 p s T au h t Y m
sjónvarpsþáttunum	s j ou n v a r_0 p s T au h t Y n Y m
sjónvarpsþætti	s j ou n v a r_0 p s T ai h t I
sjúklingsins	s j u h k l i N s I n s
skaffa	s k a f a
skammaðist	s k a m a D I s t
skarpari	s k a r_0 p a r I
skarphéðinn	s k a r_0 p h j E D I n
skarphéðinsdóttir	s k a r_0 p h j E D I n s t ou h t I r
skarphéðni	s k a r_0 p C E D n I
skarpskyggni	s k a r_0 p s c I k n I
skattpyngjur	s k a h t p_h i J c Y r
skelfd	s c E l t
skelfdum	s c E l t Y m
skelfdur	s c E l t Y r
skelltu	s c E l_0 t Y
skenkja	s c ei J_0 c a
skerjafjarðarflugslysið	s c E r j a f j a r D a r f l Y x s t l I s I D
skilafrests	s c I: l a f r E s t s
skilvirkt	s c I l v I r_0 t
skipholts	s c I p h O l_0 s
skipt	s c I f t
skipta	s c I f t a
skiptar	s c I f t a r
skiptara	s c I f t a r a
skiptinemi	s c I f t I n E m I
skipting	s c I f t i N k
skiptis	s c I f t I s
skiptumst	s c I f t Y m s t
skiptust	s c I f t Y s t
skjálfraddaður	s c au l v r a t a D Y r
skjálfrödduð	s c au l v r 9 t Y D
skjálftann	s c au l_0 t a n
skjálftanum	s c au l_0 t a n Y m
skjálftar	s c au l_0 t a r
skjálfti	s c au l_0 t I
skjálftinn	s c au l_0 t I n
skolbrúnn	s k O l p r u t n_0
skorpu	s k O r_0 p Y
skorts	s k O r_0 t s
skoðanaskipta	s k O: D a n a s c I f t a
skoðanaskipti	s k O: D a n a s c I f t I
skrapp	s k r a h p
skrifborðsskúffuna	s k r I p O r s k u f Y n a
skránni	s k r au n I
skrýtipönklaginu	s k r i: t I p 9 j N k l a j I n Y
skyggnst	s c I N s t
skálholts	s k au l h O l_0 t s
skálholtskirkja	s k au l h O l_0 t s c_h I r_0 c a
skálholtskirkju	s k au l h O l_0 t s c_h I r_0 c Y
skálholtsskóla	s k au l h O l_0 t s k ou l a
skálholtsstað	s k au l h O l_0 t s t a D
skólafulltrúinn	s k ou: l a f Y t l_0 t_h r u I n
skólastarfsins	s k ou: l a s t a r f s I n s
skólastelpa	s k ou: l a s t E l_0 p a
sköflungum	s k 9 p l u N k Y m
skörungnum	s k 9: r u N n Y m
skörðugili	s k 9 r D Y c I l I
skúffu	s k u f Y
skúffuna	s k u f Y n a
skúffunum	s k u f O n Y m
skúffur	s k u f Y r
skúffurnar	s k u f Y r t n a r
skúlptúr	s k u l_0 t u r
skútustaðahrepp	s k u: t Y s t a D a r_0 E h p
skýrslu	s c i r_0 s t l Y
skýrslumöppuna	s c i r_0 s t l Y m 9 h p Y n a
skýrslunni	s c i r_0 s t l Y n I
skýrslur	s c i r_0 s t l Y r
skýrslurnar	s c i r_0 s t l Y r t n a r
slapp	s t l a h p
slappur	s t l a h p Y r
slengdi	s t l ei N t I
slepp	s t l E h p
sleppa	s t l E h p a
sleppti	s t l E f t I
slepptu	s t l E f t Y
slunkaríki	s t l u N_0 k a r i c I
slyngur	s t l i N k Y r
slysni	s t l I s t n I
slökkt	s t l 9 x t
slökktu	s t l 9 x t Y
slöpp	s t l 9 h p
smokkfisksins	s m O h k f I s k s I n s
smokkfisksúpa	s m O h k f I s k s u p a
smásjárfrjóvgun	s m au: s j au r_0 f r j ou v k Y n
smásjármyndum	s m au: s j au r m I n t Y m
smásöluverslun	s m au: s 9 l Y v E r_0 s t l Y n
snakahvítu	s t n a: k a k_h v i t Y
snakki	s t n a h c I
snarað	s t n a: r a D
snarbjartar	s t n a r p j a r_0 t a r
snarbrattar	s t n a r p r a h t a r
snarheitum	s t n a r h ei t Y m
snarkið	s t n a r_0 c I D
snarpur	s t n a r_0 p Y r
snefil	s t n E: v I l
snefill	s t n E: v I t l_0
sneggri	s t n E k r I
sneiða	s t n ei: D a
snemma	s t n E m a
sneri	s t n E: r I
snertingu	s t n E r_0 t i N k Y
snertir	s t n E r_0 t I r
snertu	s t n E r_0 t Y
sniff	s t n I f
snákurinn	s t n au: k Y r I n
snöggklippt	s t n 9 k k l I f t
soffa	s O f a
sorps	s O r_0 p s
sparisjóð	s p a: r I s j ou D
sparisjóða	s p a: r I s j ou D a
sparisjóði	s p a: r I s j ou D I
sparisjóðir	s p a: r I s j ou D I r
sparisjóðnum	s p a: r I s j ou D n Y m
sparisjóðsins	s p a: r I s j ou D s I n s
sparkspeking	s p a r_0 k s p E c i N k
spaugi	s p 9i j I
spaugilegt	s p 9i j I l E x t
spaugilegu	s p 9i j I l E G Y
spinnerspúnn	s p I n E r_0 s p u t n_0
splæsa	s p l ai: s a
sports	s p O r_0 t s
sprengd	s p r ei N t
sprengdar	s p r ei N t a r
sprengdi	s p r ei N t I
sprengt	s p r ei N_0 t
sprunga	s p r u N k a
sprungin	s p r u J c I n
sprungið	s p r u J c I D
sprungnar	s p r u N n a r
sprungnu	s p r u N n Y
sprungu	s p r u N k Y
spryngi	s p r i J c I
spánskt	s p au n s t
stafrænna	s t a v r ai t n a
stafrænni	s t a v r ai t n I
stappaði	s t a h p a D I
starfs	s t a r f s
starfsafmæli	s t a r f s a v m ai l I
starfsdagur	s t a r f s t a G Y r
starfseminnar	s t a r f s E m I n a r
starfseminni	s t a r f s E m I n I
starfsemis	s t a r v s E m I s
starfsferil	s t a r f s f E r I l
starfsfólkinu	s t a r f s f ou l_0 c I n Y
starfsfólksins	s t a r f s f ou l_0 k s I n s
starfsgreinaráð	s t a r f s k r ei n a r au D
starfsgreinasambandsins	s t a r f s k r ei n a s a m p a n t s I n s
starfshátta	s t a r f s h au h t a
starfssystkin	s t a r f s I s c I n
starfstíma	s t a r f s t_h i m a
starfstímareglu	s t a r v s t_h i m a r E k l Y
starfsár	s t a r f s au r
starfsáætlun	s t a r f s au ai h t l Y n
stefnuskránni	s t E p n Y s k r au n I
stefnuvirkt	s t E p n Y v I r_0 t
steingleyma	s t ei N k l ei m a
steingleymdi	s t ei N k l ei m t I
steinn	s t ei t n_0
steinsteyptan	s t ei n s t ei f t a n
sterkstraumshluti	s t E r_0 k s t r 9i m s l_0 Y t I
sterkt	s t E r_0 t
steyptu	s t ei f t Y
stillt	s t I l_0 t
stirndi	s t I r n t I
stirðna	s t I r t n a
stjórnhnappinum	s t j ou r t n n_0 a h p I n Y m
stofnsett	s t O p n_0 s E h t
stofnsins	s t O p n_0 s I n s
stofnskjal	s t O p n_0 s c a l
stofnstærð	s t O p n_0 s t ai r D
stofnsáttmála	s t O p n_0 s au h t m au l a
stofuprýðin	s t O: v Y p_h r i D I n
stoppaði	s t O h p a D I
stoppistöð	s t O h p I s t 9 D
strandbergs	s t r a n t p E r k s
strangt	s t r au N_0 t
strangtrúuðu	s t r au N k t_h r u Y D Y
strengdi	s t r ei N t I
strengnum	s t r ei N n Y m
stungið	s t u J c I D
stungum	s t u N k Y m
sturlungum	s t Y r t l u N k Y m
stuttklippt	s t Y h t k l I f t
stuttklippta	s t Y h t k l I f t a
stuðningsfólks	s t Y D n i N s f ou l_0 k s
stuðningteymis	s t Y D n i N k t_h ei m I s
styrks	s t I r_0 k s
styrkt	s t I r_0 t
styrktar	s t I r_0 t a r
styrktaraðilar	s t I r_0 t a r a D I l a r
styrktaraðilum	s t I r_0 t a r a D I l Y m
styrktir	s t I r_0 t I r
styrktist	s t I r_0 t I s t
styrktu	s t I r_0 t Y
styrktur	s t I r_0 t Y r
stærðarflokki	s t ai r D a r f l O h c I
stórsnillingar	s t ou r_0 s t n I t l i N k a r
stórsniðuga	s t ou r_0 s t n I D Y G a
stökkt	s t 9 x t
stöðugildi	s t 9: D Yi c I l t I
stöðugildum	s t 9: D Y c I l t Y m
sumarlangt	s Y: m a r l au N_0 t
sundblöðkurnar	s Y n t p l 9 T k Y r t n a r
sundlaugin	s Y n t l 9i j I n
sundlauginni	s Y n t l 9i j I n I
sungin	s u J c I n
sungnir	s u N n I r
sunnudagsmorgnum	s Y n Y t a x s m O r t n Y m
surts	s Y r_0 t s
surtsey	s Y r_0 t s ei
suðrænn	s Y D r ai t n_0
svampsessur	s v a m_0 p s E s Y r
svarts	s v a r_0 s
svartsengi	s v a r_0 t s ei J c I
svartsýni	s v a r_0 t s i n I
svefnsins	s v E p n_0 s I n s
svefnskuld	s v E p n_0 s k Y l t
svefnskála	s v E p n_0 s k au l a
svefnskálann	s v E p n_0 s k au l a n
svefnskálanum	s v E p n_0 s k au l a n Y m
sveinn	s v ei t n_0
svekktur	s v E x t Y r
svelgdist	s v E l t I s t
svengd	s v ei N t
svínavatnshreppi	s v i: n a v a s r_0 E h p I
syng	s i N k
syngdu	s i N t Y
syngið	s i J c I D
syngja	s i J c a
syngjandi	s i J c a n t I
systkin	s I s c I n
systkini	s I s c I n I
systkinin	s I s c I n I n
systurflokkur	s I s t Y r f l O h k Y r
systurflokkurinn	s I s t Y r_0 f l O h k Y r I n
sálfræðingi	s au l f r ai D i J c I
sálfræðingur	s au l f r ai D i N k Y r
sálugi	s au: l Yi j I
sænskt	s ai n s t
sæplasts	s ai p_h l a s t s
símaskránni	s i: m a s k r au n I
sívertsen	s i: v E r_0 t s E n
síðkastið	s i D k_h a s t I D
sóknarprests	s ou h k n a r_0 p r E s t s
sólbrúnn	s ou l p r u t n_0
sópransöngkona	s ou: p_h r a n s 9i n k O n a
sökkti	s 9 x t I
sökktu	s 9 x t Y
söngnum	s 9i N n Y m
söngnám	s 9i N k n au m
söngvakeppnin	s 9i N k v a c_h E h p n I n
tafli	t_h a p l I
tal	t_h a: l
talar	t_h a: l a r
talsmenn	t_h a l s m E n
talsverður	t_h a l s v E r D Y r
tanki	t_h au J_0 c I
tankinum	t_h au J_0 c I n Y m
tanks	t_h au N_0 k s
tapa	t_h a: p a
tapist	t_h a: p I s t
taugasérfræðinginn	t_h 9i: G a s j E r_0 f r ai D i J c I n
taugungamótum	t_h 9i: G u N k a m ou t Y m
tauið	t_h 9i: I D
taumurinn	t_h 9i: m Y r I n
tebollanum	t_h E: p O t l a n Y m
tefld	t_h E l t
tefldar	t_h E l t a r
tefldi	t_h E l t I
tefldist	t_h E l t I s t
tefldu	t_h E l t Y
teknu	t_h E h k n Y
tekst	t_h E k s t
telur	t_h E: l Y r
tengd	t_h ei N t
tengda	t_h ei N t a
tengdadóttir	t_h ei N t a t ou h t I r
tengdaforeldrar	t_h ei N t a f O r E l t r a r
tengdaforeldrum	t_h ei N t a f O r E l t r Y m
tengdaföður	t_h ei N t a f 9 D Y r
tengdamóðir	t_h ei N t a m ou D I r
tengdamóður	t_h ei N t a m ou D Y r
tengdar	t_h ei N t a r
tengdasonar	t_h ei N t a s O n a r
tengdasonur	t_h ei N t a s O n Y r
tengt	t_h ei N_0 t
tennur	t_h E n Y r
teppagerð	t_h E h p a c E r D
teppum	t_h E h p Y m
textameðferð	t_h E k s t a m E D f E r D
textana	t_h E k s t a n a
textavarps	t_h E k s t a v a r_0 p s
tignarleg	t_h I k n a r l E G
tilbrigði	t_h I l p r I G D I
tildrög	t_h I l t r 9 G
tileinka	t_h I: l ei N_0 k a
tilgangurinn	t_h I l k au N k Y r I n
tilhugsunin	t_h I: l h Y k s Y n I n
tilkomu	t_h I l k_h O m Y
tillöguna	t_h I l 9 G Y n a
tiltekinna	t_h I l t_h E c I n a
tippinu	t_h I h p I n Y
tjald	t_h j a l t
tjaldvagninum	t_h j a l t v a k n I n Y m
toppa	t_h O h p a
torgsins	t_h O r k s I n s
trausts	t_h r 9i s t s
traðkað	t_h r a T k a D
trúnaðartrausts	t_h r u: n a D a r_0 t_h r 9i s t s
trúnni	t_h r u n I
tugi	t_h Yi j I
tugir	t_h Yi j I r
tungan	t_h u N k a n
tungli	t_h u N l I
tunglsljósi	t_h u N l s t l j ou s I
tungltímatal	t_h u N l t_h i m a t_h a l
tungnár	t_h u N n au r
tungumáli	t_h u N k Y m au l I
tungumálsins	t_h u N k Y m au l s I n s
tvípunktur	t_h v i: p_h u n_0 t Y r
tylftir	t_h I l_0 t I r
tyrkneskt	t_h I r_0 k n E s t
táknið	t_h au h k n I D
tánni	t_h au n I
tímapunkti	t_h i: m a p u n_0 t I
tíðarandann	t_h i: D a r a n t a n
tíðkist	t_h i T c I s t
tólftu	t_h ou l_0 t Y
tónlistarflutning	t_h ou n l I s t a r_0 f l Y h t n I N k
tónlistarflutningur	t_h ou n l I s t a r f l Y h t n I N k Y r
tónninn	t_h ou t n I n
tölfræði	t_h 9 l f r ai D I
tölusveinninn	t_h 9: l Y s v ei t n I n
umferðarslysi	Y m f E r D a r_0 s t l I s I
umferðarslysum	Y m f E r D a r_0 s t l I s Y m
umgengni	Y m c ei N n I
umhverfisverndar	Y m k_h v E r v I s v E r n t a r
umhverfisverndarsamtökin	Y m k_h v E r v I s v E r n t a r_0 s a m t_h 9 c I n
umhverfisvænna	Y m k_h v E r v I s v ai t n a
umkringt	Y m k_h r i N_0 t
undangengna	Y n t a n c ei N n a
undangengnu	Y n t au n c ei N n Y
undanúrslitum	Y n t a n u r_0 s t l I t Y m
undirbúningnum	Y n t I r p u n i N n Y m
unnsteinn	Y n s t ei t n_0
uppfærslum	Y h p f ai r_0 s t l Y m
uppfærslunni	Y h p f ai r_0 s t l Y n I
upptalning	Y h p t_h a l n i N k
upptalningu	Y h p t_h a l n i N k Y
upptökuferlið	Y h p t_h 9 k Y f E r t l I D
upptökuforritið	Y h p t_h 9 k Y f O r I t I D
upptökuheimili	Y h p t_h 9 k Y h ei m I l I
upptökuheimilinu	Y h p t_h 9 k Y h ei m I l I n Y
upptökuheimilið	Y h p t_h 9 k Y h ei m I l I D
upptökum	Y h p t_h 9 k Y m
upptökur	Y h p t_h 9 k Y r
upptökutækið	Y h p t_h 9 k Y t_h ai c I D
urriðavatnsdölum	Y r I D a v a s t 9 l Y m
vagnsins	v a k n_0 s I n s
valdabrölts	v a l t a p r 9 l_0 t s
valfrelsi	v a l f r E l s I
varpstöðva	v a r_0 p s t 9 D v a
varptíma	v a r_0 p t_h i m a
vatns	v a s
vatnsafls	v a s a p l_0 s
vatnsborðið	v a s p O r D I D
vatnsbotninum	v a s p O h t n I n Y m
vatnsból	v a s p ou l
vatnsdrykkja	v a s t r I h c a
vatnsdælur	v a s t ai l Y r
vatnsenda	v a s E n t a
vatnsendalandi	v a s E n t a l a n t I
vatnsfellsvirkjun	v a s f E l s v I r_0 c Y n
vatnsflauminn	v a s f l 9i m I n
vatnsglas	v a s k l a s
vatnsglasi	v a s k l a s I
vatnsglasinu	v a s k l a s I n Y
vatnsglasið	v a s k l a s I D
vatnshrædd	v a s r_0 ai t
vatnsins	v a s I n s
vatnsleiðslur	v a s t l ei D s t l Y r
vatnsleysni	v a s t l ei s t n I
vatnsleysnin	v a s t l ei s t n I n
vatnsleysustrandarhreppi	v a s t l ei s Y s t r a n t a r_0 E h p I
vatnsleysustrandarhrepps	v a s t l ei s Y s t r a n t a r_0 E h p s
vatnsleysustrandarhreppur	v a s t l ei s Y s t r a n t a r_0 E h p Y r
vatnsleysuströnd	v a s t l ei s Y s t r 9 n t
vatnslitamyndum	v a s t l I t a m I n t Y m
vatnsmelóna	v a s m E l ou n a
vatnsmelónu	v a s m E l ou n Y
vatnsmelónuna	v a s m E l ou n Y n a
vatnsmýrar	v a s m i r a r
vatnsmýri	v a s m i r I
vatnsmýrin	v a s m i r I n
vatnsmýrina	v a s m i r I n a
vatnsmýrinni	v a s m i r I n I
vaxtarskerðingin	v a k s t a r_0 s c E r D i J c I n
velgengni	v E l c ei N n I
velktan	v E l t_h a n
velktist	v E l_0 t I s t
verks	v E r_0 k s
verksamningagerð	v E r_0 k s a m n i N k a c E r D
verksins	v E r_0 k s I n s
verksmiðja	v E r_0 k s m I D j a
verksmiðjanna	v E r_0 k s m I D j a n a
verksmiðju	v E r_0 k s m I D j Y
verksmiðjuhúss	v E r_0 k s m I D j Y h u s
verksmiðjum	v E r_0 k s m I D j Y m
verksmiðjuna	v E r_0 k s m I D j Y n a
verksmiðjunnar	v E r_0 k s m I D j Y n a r
verksmiðjunni	v E r_0 k s m I D j Y n I
verksmiðjur	v E r_0 k s m I D j Y r
verksmiðjurnar	v E r_0 k s m I D j Y r t n a r
verksmiðjustrompa	v E r_0 k s m I D j Y s t r O m_0 p a
verkstjóra	v E r_0 k s t j ou r a
verkstjórafélaginu	v E r_0 k s t j ou r a f j E l ai j I n Y
verkstjóri	v E r_0 k s t j ou r I
verkstjórn	v E r_0 k s t j ou r t n_0
verkstæðinu	v E r_0 k s t ai D I n Y
verkstæðið	v E r_0 k s t ai D I D
verkstæðum	v E r_0 k s t ai D Y m
verksummerki	v E r_0 k s Y m E r_0 c I
verksvið	v E r_0 k s v I D
verktaka	v E r_0 t_h a k a
verktakanum	v E r_0 t_h a k a n Y m
verktaki	v E r_0 t_h a c I
verktakinn	v E r_0 t_h a c I n
verktökum	v E r_0 t_h 9 k Y m
vernda	v E r n t a
verndar	v E r n t a r
verndara	v E r n t a r a
verndargildi	v E r n t a r c I l t I
verndarhendi	v E r n t a r_0 h E n t I
verndari	v E r n t a r I
verndarvæng	v E r n t a r v ai N k
verndaði	v E r n t a D I
verndi	v E r n t I
verndun	v E r n t Y n
verpti	v E r_0 t I
versna	v E r_0 s t n a
versnandi	v E r_0 s t n a n t I
versnaði	v E r_0 s t n a D I
versnun	v E r_0 s t n Y n
verðlaunanna	v E r D l 9i n a n a
verðlaunum	v E r D l 9i n Y m
verðleggja	v E r D l E c a
vestfjarðaprófastsdæmi	v E s t f j a r D a p_h r ou f a s t s t ai m I
vestmarks	v E s t m a r_0 k s
vettugi	v E h t Yi j I
vilbergsdóttir	v I l p E r k s t ou h t I r
viljugir	v I l j Yi j I r
villingaholtshreppi	v I t l i N k a h O l_0 t s r_0 E h p I
vindlaverksmiðju	v I n t l a v E r_0 k s m I D j Y
virktum	v I r_0 t Y m
viðkom	v I D k_h O m
volgt	v O l_0 t
vésteinn	v j E s t ei t n_0
vönkuð	v 9 N_0 k Y D
yfirflugi	I: v I r f l Yi j I
yfirgnæfa	I: v I r_0 k n ai v a
yfirgnæfði	I: v I r k n ai v D I
yfirskeggi	I: v I r_0 s c E c I
yfirskini	I: v I r_0 s c I n I
yngjast	i J c a s t
yngra	i N k r a
yngri	i N k r I
yngsti	i N s t I
yngstu	i N s t Y
yppt	I f t
yppti	I f t I
ypptir	I f t I r
ypptu	I f t Y
ábyggilega	au: p I c I l E G a
ábyrgjast	au: p I r c a s t
ábyrgst	au: p I r s t
ábyrgð	au: p I r D
ábyrgðar	au: p I r D a r
ábyrgðarmaður	au: p I r D a r m a D Y r
ábyrgðarmenn	au: p I r D a r m E n
ábyrgðin	au: p I r D I n
ábyrgðina	au: p I r D I n a
ábyrgðir	au: p I r D I r
ábótavant	au: p ou t a v a n_0 t
ábúðarfullur	au: p u D a r f Y t l Y r
áfallahjálp	au: f a t l a C au l_0 p
áfangaskýrsla	au: f au N k a s c i r_0 s t l a
áfangastað	au: f au N k a s t a D
áfangi	au: f au J c I
áfergju	au: f E r c Y
áfrýjunarefnd	au: f r i j Y n a r E m t
áföllum	au: f 9 t l Y m
ágengni	au: c ei N n I
ágreiningsefni	au k r ei n i N s E p n I
ágreiningsmál	au k r ei n i N s m au l
ágætlega	au: c ai t l E G a
ágætu	au: c ai t Y
ágústsdóttur	au: k u s t ou h t Y r
ágústssonar	au: G u s t s O n a r
ágústssyni	au: k u s t s I n I
áhafnarinnar	au: h a p n a r I n a r
áhafnarskipta	au: h a p n a r_0 s c I f t a
áhersla	au: h E r_0 s t l a
áherslu	au: h E r_0 s t l Y
áherslubreytingar	au: h E r_0 s t l Y p r ei t i N k a r
áherslur	au: h E r_0 s t l Y r
áheyrnarfulltrúar	au: h ei r t n a r f Y t l_0 t_h r u a r
áhrifamesti	au r_0 I v a m E s t I
áhrifaríkt	au r_0 I v a r i x t
áhrifasvæði	au r_0 I v a s v ai D I
áhugasvið	au: h Y G a s v I D
áhugavert	au: h Y G a v E r_0 t
áhugi	au: h Yi j I
áhuginn	au: h Yi j I n
áhyggjuefni	au: h I c Y E p n I
áhyggjufullir	au: h I c Y f Y t l I r
áhyggjulaus	au: h I c Y l 9i s
áhyggjulaust	au: h I c Y l 9i s t
áhyggjuleysi	au: h I c Y l ei s I
áhættusöm	au: h ai h t Y s 9 m
áhættuþætti	au: h ai h t Y T ai h t I
ákall	au: k_h a t l_0
ákallaði	au: k_h a t l a D I
ákjósanlegt	au: c_h ou s a n l E x t
ákvarða	au: k_h v a r D a
ákvarðana	au: k_h v a r D a n a
ákvaðst	au: k_h v a D s t
ákveðin	au: k_h v E D I n
ákveðinna	au: k_h v E D I n a
ákveðinnar	au: k_h v E D I n a r
ákveðið	au: h v E D I D
ákveðna	au: k_h v E D n a
ákveðni	au: k_h v E D n I
ákveðnir	au: k_h v E D n I r
ákveðnu	au: k_h v E D n Y
ákveðum	au: k_h v E D Y m
ákveður	au: k_h v E D Y r
ákváðu	au: k_h v au D Y
ákvæði	au: k_h v ai D I
ákvæðinu	au: k_h v ai D I n Y
ákvæðisins	au k_h v ai D I s I n s
ákvæðum	au: k_h v ai D Y m
ákvörðunarlandinu	au: k_h v 9 r D Y n a r l a n t I n Y
ákvörðunarstað	au: k_h v 9 r D Y n a r_0 s t a D
ákvörðuninni	au: k_h v 9 r D Y n I n I
ákvörðuð	au: k_h v 9 r D Y D
ákært	au: c_h ai r_0 t
áköfu	au: k_h 9 v Y
álengdar	au: l ei N t a r
álfhólsvegi	au l v h ou l s v ei j I
álframleiðslu	au: l f r a m l ei D s t l Y
álfrún	au l f r u n
álft	au l_0 t
álftafirði	au l_0 t a f I r D I
álftagerði	au l_0 t a c E r D I
álftanes	au l_0 t a n E s
álftanesskóla	au l_0 t a n E s k ou l a
álykta	au: l I x t a
ályktað	au: l I x t a D
ámátlega	au: m au t l E G a
ánna	au n a
ánni	au n I
ánægjulegt	au: n ai j Y l E x t
ánægjulegu	au: n ai j Y l E G Y
árangurslausri	au: r au N k Y r_0 s l 9i s r I
árangurslaust	au: r au N k Y r_0 s t l au s t
árangursríkt	au: r au N k Y r_0 s r i x t
áratugina	au: r a t_h Yi j I n a
áratuginn	au: r a t_h Yi j I n
áratugir	au: r a t_h Yi j I r
árbakka	au: r p a h k a
árbæjarsafns	au r p ai j a r_0 s a p n_0 s
árekstraprófanir	au: r E k s t r a p_h r ou v a n I r
árgangi	au r k au J c I
árgjöll	au r c 9 t l_0
árgöngum	au r k 9i N k Y m
árleg	au: r l E G
árskógsströnd	au r_0 s k ou G s t r 9 n t
ársreikninga	au r_0 s r ei h k n i N k a
árstíðabundnir	au r_0 s t_h i D a p Y n t n I r
ársæli	au r_0 s ai l I
ártal	au r_0 t_h a l
ártúni	au r_0 t_h u n I
ártúnsskóla	au r_0 t_h u n s k ou l a
árátta	au: r au h t a
áráttu	au: r au h t Y
ásatrúar	au: s a t_h r u a r
ásbjörns	au s p j 9 r_0 s
ásbjörnsdóttir	au s p j 9 r_0 s t ou h t I r
ásetningi	au: s E h t n I J c I
ásgeirssyni	au s c ei r_0 s I n I
ásgrímssonar	au s k r i m s O n a r
ásigkomulagi	au: s I G k_h O m Y l ai j I
ásjáandi	au: s j au a n t I
ásjár	au: s j au r
ásjóna	au: s j ou n a
áskotnast	au: s k O h t n a s t
áskrift	au s k r I f t
áskriftargjald	au: s k r I f t a r c a l t
áskriftarvefurinn	au: s k r I f t a r v E v Y r I n
ásmegin	au s m ei j I n
ásmundsson	au s m Y n t s O n
ásrúnar	au: s r u n a r
ástandsbreyting	au: s t a n t s p r ei t i N k
ástarsamböndum	au s t a r_0 s a m p 9 n t Y m
ástarsögu	au s t a r_0 s 9 G Y
ástfangnir	au s t f au N n I r
ástkonur	au s t k_h O n Y r
ástríðufullt	au s t r i D Y f Y l_0 t
ástvaldsson	au s t v a l t s O n
ásubergsskipið	au: s Y p E r k s c I p I D
ásvallagötu	au: s v a t l a k 9 t Y
ásótti	au: s ou h t I
átakanleg	au: t_h a k a n l E G
áttaviti	au h t a v I t I
áttað	au h t a D
ávallt	au: v a l_0 t
ávarp	au: v a r_0 p
ávarpi	au: v a r_0 p I
áætlunarbíllinn	au: ai h t l Y n a r p i t l I n
áætlunarflug	au: ai h t l Y n a r f l Y G
áætlunum	au: ai h t l Y n Y m
áðurnefndum	au: D Y r n E m t Y m
áþekkt	au: T E x t
áþreifanlega	au: T r ei v a n l E G a
æfingaprógramm	ai: v i N k a p_h r ou k r a m
íbyggin	i: p I c I n
íbúanna	i: p u a n a
íbúðalánasjóð	i: p u D a l au n a s j ou D
íbúðalánasjóði	i: p u D a l au n a s j ou D I
íbúðalánasjóðs	i: p u D a l au n a s j ou D s
íbúðalánasjóður	i: p u D a l au n a s j ou D Y r
ígulker	i: G Y l c_h E r
íhaldsseggir	i: h a l t s E c I r
íhaldssemi	i: h a l t s E m I
íhugar	i: h Y G a r
íklæddur	i k_h l ai t Y r
írafár	i: r a f au r
írlands	i r l a n t s
írsk	i r_0 s k
írski	i r_0 s c I
írskt	i r_0 s t
írskum	i r_0 s k Y m
írskuna	i r_0 s k Y n a
írskur	i r_0 s k Y r
ísafjarðarprófastsdæma	i: s a f  j a r D a r_0 p_h r ou f a s t ai m a
ísafjarðarsýslu	i: s a f j a r D a r_0 s i s t l Y
ísfisktogaranum	i: s f I s k t_h O G a r a n Y m
ísfélagið	i: s f j E l ai j I D
íshjúpnum	i s C u h p n Y m
íslamskra	i s t l a m s k r a
íslandsbanki	i s t l a n t s p au J_0 c I
íslandsdeildar	i s t l a n t s t ei l t a r
íslandsflugs	i s t l a n t s f l Y x s
íslandsklukkan	i s t l a n t s k_h l Y h k a n
íslandsmeistarans	i s t l a n t s m ei s t a r a n s
íslandsmótsins	i s t l a n t s m ou t s I n s
íslandspóstur	i s t l a n t s p_h ou s t Y r
íslandssaga	i s t l a n t s a G a
íslandsskeið	i s t l a n t s c ei D
íslandssíma	i s t l a n t s i m a
íslandssögunni	i s t l a n t s 9 G Y n I
íslandsvinurinn	i s t l a n t s v I n Y r I n
ísleifs	i s t l ei f s
íslenskar	i s t l E n s k a r
íslenskt	i s t l E n s t
ísraelsk	i: s r a E l s k
ísraelska	i: s r a E l s k a
ísraelskir	i: s r a E l s c I r
ísraelsku	i: s r a E l s k Y
ístölt	i: s t_h 9 l_0 t
ísólfsson	i: s ou l f s O n
ítalskt	i: t a l s t
ítrekar	i: t r E k a r
íþróttafatnað	i T r ou h t a f a h t n a D
íþróttafélaga	i T r ou h t a f j E l a G a
íþróttafélög	i: T r ou h t a f j E l 9 G
íþróttafólk	i: T r ou h t a f ou l_0 k
íþróttahreyfingarinnar	i T r ou h t a r_0 ei v i N k a r I n a r
íþróttaiðkun	i T r ou h t a I T k Y n
íþróttamaður	i T r ou h t a m a D Y r
íþróttamönnum	i T r ou h t a m 9 n Y m
íþróttavellinum	i T r ou h t a v E t l I n Y m
íþyngjandi	i: T i J c a n t I
óalgengt	ou: a l c ei N_0 t
óburstaða	ou: p Y r_0 s t a D a
ógeðfellt	ou: c E D f E l_0 t
ógeðslegt	ou: c E D s t l E x t
ógilt	ou c I l_0 t
óheppin	ou: h E h p I n
óheppni	ou: h E h p n I
óheppnir	ou: h E h p n I r
óhreinn	ou r_0 ei t n_0
ókunnugir	ou: k_h Y n Yi j I r
ólafs	ou: l a f s
ólafsdóttur	ou: l a f s t ou h t Y r
ólafsfjarðar	ou: l a f s f j a r D a r
ólafsfjörð	ou: l a f s f j 9 r D
ólafssonar	ou: l a f s O n a r
ólafssyni	ou: l a f s I n I
ólafsvíkur	ou: l a f s v i k Y r
ólafsvíkurkirkju	ou: l a f s v i k Y r_0 c_h I r_0 c Y
óljósri	ou l j ou s r I
ólykt	ou: l I x t
ólympíunefndarinnar	ou: l I m p_h i j Y n E m t a r I n a r
ólympíuskrifstofunni	ou: l I m p_h i j Y s k r I f s t O v Y n I
ólæknandi	ou: l ai h k n a n t I
ómerkt	ou: m E r_0 t
óperusöngvari	ou: p_h E r Y s 9i N k v a r I
óralangt	ou: r a l au N_0 t
ósjálfbjarga	ou: s j au l f p j a r k a
ósjálfrátt	ou: s j au l v r au h t
ósjálfráð	ou: s j au l v r au D
óskammfeilni	ou s k a m f ei l n I
óskaplegur	ou s k a p l E G Y r
óskarsverðlaun	ou s k a r_0 s v E r D l 9i n
óskarsverðlauna	ou s k a r_0 s v E r D l 9i n a
óskipt	ou s c I f t
óspör	ou s p 9 r
ótalmargt	ou: t_h a l m a r_0 t
ótrauðir	ou: t_h r 9i D I r
ótrauður	ou: t_h r 9i D Y r
óviðkomandi	ou: v I D k_h O m a n t I
óyggjandi	ou: I c a n t I
óöryggis	ou: 9 r I c I s
óþarflega	ou: T a r v l E G a
óþarft	ou: T a r_0 t
óþekkt	ou: T E x t
óþekkta	ou: T E x t a
óþekktar	ou: T E x t a r
óþekkti	ou: T E x t I
óþekktum	ou: T E x t Y m
óþekktur	ou: T E x t Y r
örbirgð	9 r p I r D
úlfrúnar	u l v r u n a r
úrslita	u r_0 s t l I t a
úrslitaleikinn	u r_0 s t l I t a l ei c I n
úrslitaleikur	u r_0 s t l I t a l ei k Y r
úrslitaáhrif	u r_0 s t l I t a au r_0 I
úrslitaþjónustan	u r_0 s t l I t a T j ou n Y s t a n
útvarps	u: t v a r_0 p s
útvarpsdagbókin	u: t v a r_0 p s t a G p ou c I n
útvarpshausar	u: t v a r_0 p s h 9i s a r
útvarpstæki	u: t v a r_0 p s t_h ai c I
útvarpstækinu	u: t v a r_0 p s t_h ai c I n Y
ýlfrandi	i l v r a n t I
ýlfruðu	i l v r Y D Y
þarfnast	T a r t n a s t
þarfnaðist	T a r t n a D I s t
þarfnist	T a r t n I s t
þekkt	T E x t
þekktan	T E x t a n
þekktar	T E x t a r
þekktari	T E x t a r I
þekktast	T E x t a s t
þekktasta	T E x t a s t a
þekktasti	T E x t a s t I
þekktastur	T E x t a s t Y r
þekkti	T E x t I
þekktir	T E x t I r
þekktirðu	T E x t I r D Y
þekktu	T E x t Y
þekktum	T E x t Y m
þenkirðu	T ei J_0 c I r D Y
þingeyskt	T i J c ei s t
þinglýsts	T i N k l i s
þjóðminjasafns	T j ou D m I n j a s a p n_0 s
þjóðminjasafnsins	T j ou D m I n j a s a p n_0 s I n s
þorbergs	T O r p E r k s
þorbergsdóttir	T O r p E r k s t ou h t I r
þorskeldi	T O r_0 s c E l t I
þorski	T O r_0 s c I
þorskinn	T O r_0 s c I n
þráðbeinn	T r au D p ei t n_0
þungt	T u N_0 t
þurftir	T Y r_0 t I r
þurftu	T Y r_0 t Y
þurftum	T Y r_0 t Y m
þyngd	T i N t
þyngdar	T i N t a r
þyngdarbreytinga	T i N t a r p r ei t i N k a
þyngdarhruni	T i N t a r_0 Y n I
þyngdarlaust	T i N t a r l 9i s t
þyngdarstig	T i N t a r_0 s t I G
þyngdaráhrif	T i N t a r au r_0 I v
þyngingar	T i n c i N k a r
þyngist	T i J c I s t
þyngjast	T i J c a s t
þyngra	T i N k r a
þyngri	T i N k r I
þyngsli	T i N s t l I
þyngst	T i N s t
þyngstu	T i N s t Y
þyrfti	T I r_0 t I
þyrftir	T I r_0 t I r
þyrftum	T I r_0 t Y m
þyrptust	T I r_0 t Y s t
þórbergs	T ou r p E r k s
þörfnumst	T 9 r t n Y m s t
